AAAGCAAAGAAACGCC-1	AAAGCAAAGAAACGCC
AAAGCAAGTATGAAAC-1	AAAGCAAGTATGAAAC
AAAGCAATCTGCTTGC-1	AAAGCAATCTGCTTGC
AAAGTAGCAACGATGG-1	AAAGTAGCAACGATGG
AAAGTAGCATCTCGCT-1	AAAGTAGCATCTCGCT
AAATGCCAGTTCCACA-1	AAATGCCAGTTCCACA
AAATGCCCATGTAAGA-1	AAATGCCCATGTAAGA
AAATGCCGTTCCACGG-1	AAATGCCGTTCCACGG
AACACGTCATCACGTA-1	AACACGTCATCACGTA
AACACGTGTAACGACG-1	AACACGTGTAACGACG
AACACGTGTACATCCA-1	AACACGTGTACATCCA
AACACGTTCACATGCA-1	AACACGTTCACATGCA
AACCATGCATTAGGCT-1	AACCATGCATTAGGCT
AACCATGTCCAAATGC-1	AACCATGTCCAAATGC
AACCGCGAGTAAGTAC-1	AACCGCGAGTAAGTAC
AACCGCGGTTCGTGAT-1	AACCGCGGTTCGTGAT
AACCGCGTCGTCACGG-1	AACCGCGTCGTCACGG
AACCGCGTCTGTACGA-1	AACCGCGTCTGTACGA
AACTCCCAGTACGCGA-1	AACTCCCAGTACGCGA
AACTCCCCAATAGAGT-1	AACTCCCCAATAGAGT
AACTCCCTCGCGCCAA-1	AACTCCCTCGCGCCAA
AACTCTTGTATTCGTG-1	AACTCTTGTATTCGTG
AACTTTCGTTAAAGAC-1	AACTTTCGTTAAAGAC
AAGACCTAGCCAGTAG-1	AAGACCTAGCCAGTAG
AAGGAGCCAATGGTCT-1	AAGGAGCCAATGGTCT
AAGGAGCTCGGCGGTT-1	AAGGAGCTCGGCGGTT
AAGGCAGAGGTGCACA-1	AAGGCAGAGGTGCACA
AAGGCAGTCTTGCAAG-1	AAGGCAGTCTTGCAAG
AAGGTTCGTTACGACT-1	AAGGTTCGTTACGACT
AAGTCTGCACACCGCA-1	AAGTCTGCACACCGCA
AAGTCTGCACCAGCAC-1	AAGTCTGCACCAGCAC
ACACCAACAAGCCCAC-1	ACACCAACAAGCCCAC
ACACCAACACGGACAA-1	ACACCAACACGGACAA
ACACCAAGTGACTCAT-1	ACACCAAGTGACTCAT
ACACCAAGTTATCGGT-1	ACACCAAGTTATCGGT
ACACCCTAGGTGTTAA-1	ACACCCTAGGTGTTAA
ACACCCTGTGGTAACG-1	ACACCCTGTGGTAACG
ACACCGGCACGTTGGC-1	ACACCGGCACGTTGGC
ACACCGGGTGACGCCT-1	ACACCGGGTGACGCCT
ACAGCCGAGGCCGAAT-1	ACAGCCGAGGCCGAAT
ACAGCCGGTTAAGTAG-1	ACAGCCGGTTAAGTAG
ACAGCCGTCATCTGCC-1	ACAGCCGTCATCTGCC
ACAGCTAAGTGACTCT-1	ACAGCTAAGTGACTCT
ACAGCTATCAGAGGTG-1	ACAGCTATCAGAGGTG
ACAGCTATCAGCTGGC-1	ACAGCTATCAGCTGGC
ACAGCTATCGGCATCG-1	ACAGCTATCGGCATCG
ACATACGCAGCTTCGG-1	ACATACGCAGCTTCGG
ACATCAGCAATAGAGT-1	ACATCAGCAATAGAGT
ACATCAGGTATATCCG-1	ACATCAGGTATATCCG
ACATGGTAGCTAGTCT-1	ACATGGTAGCTAGTCT
ACATGGTGTTGGACCC-1	ACATGGTGTTGGACCC
ACATGGTTCTTGCCGT-1	ACATGGTTCTTGCCGT
ACCTTTAGTTCACGGC-1	ACCTTTAGTTCACGGC
ACCTTTAGTTTGTTTC-1	ACCTTTAGTTTGTTTC
ACCTTTATCTTGTACT-1	ACCTTTATCTTGTACT
ACGAGCCAGCGTCAAG-1	ACGAGCCAGCGTCAAG
ACGAGGAAGCGATAGC-1	ACGAGGAAGCGATAGC
ACGAGGATCGCAGGCT-1	ACGAGGATCGCAGGCT
ACGATACAGAGTACAT-1	ACGATACAGAGTACAT
ACGATACCAGACGTAG-1	ACGATACCAGACGTAG
ACGATGTCAAGCGTAG-1	ACGATGTCAAGCGTAG
ACGATGTGTAGCTGCC-1	ACGATGTGTAGCTGCC
ACGATGTGTGTCCTCT-1	ACGATGTGTGTCCTCT
ACGCAGCAGGTTACCT-1	ACGCAGCAGGTTACCT
ACGCAGCGTGGGTCAA-1	ACGCAGCGTGGGTCAA
ACGCCGACAAGTTGTC-1	ACGCCGACAAGTTGTC
ACGCCGACAGATCTGT-1	ACGCCGACAGATCTGT
ACGCCGAGTAACGACG-1	ACGCCGAGTAACGACG
ACGGAGACAGGGATTG-1	ACGGAGACAGGGATTG
ACGGCCACAGGAATCG-1	ACGGCCACAGGAATCG
ACGGCCACAGTCGATT-1	ACGGCCACAGTCGATT
ACGGCCAGTCAAAGCG-1	ACGGCCAGTCAAAGCG
ACGGGCTTCTTGCATT-1	ACGGGCTTCTTGCATT
ACGGGTCAGCTGTCTA-1	ACGGGTCAGCTGTCTA
ACGGGTCAGGAATGGA-1	ACGGGTCAGGAATGGA
ACGTCAAAGGAGCGTT-1	ACGTCAAAGGAGCGTT
ACGTCAAGTATCAGTC-1	ACGTCAAGTATCAGTC
ACTATCTAGACTGTAA-1	ACTATCTAGACTGTAA
ACTATCTAGGCCATAG-1	ACTATCTAGGCCATAG
ACTATCTGTAGCCTCG-1	ACTATCTGTAGCCTCG
ACTGAGTAGACCTTTG-1	ACTGAGTAGACCTTTG
ACTGAGTTCGGTCCGA-1	ACTGAGTTCGGTCCGA
ACTGATGCAAAGTCAA-1	ACTGATGCAAAGTCAA
ACTGATGTCAATACCG-1	ACTGATGTCAATACCG
ACTTACTAGCTAACTC-1	ACTTACTAGCTAACTC
ACTTACTCATCACCCT-1	ACTTACTCATCACCCT
ACTTGTTGTCCGAGTC-1	ACTTGTTGTCCGAGTC
ACTTTCAGTTCCTCCA-1	ACTTTCAGTTCCTCCA
AGACGTTTCAGCATGT-1	AGACGTTTCAGCATGT
AGAGCGAGTCGTGGCT-1	AGAGCGAGTCGTGGCT
AGAGCGATCAAGATCC-1	AGAGCGATCAAGATCC
AGAGCGATCACGCATA-1	AGAGCGATCACGCATA
AGAGCGATCGTCTGAA-1	AGAGCGATCGTCTGAA
AGAGCTTAGAAGGCCT-1	AGAGCTTAGAAGGCCT
AGAGCTTCAGGGTACA-1	AGAGCTTCAGGGTACA
AGAGCTTGTGAACCTT-1	AGAGCTTGTGAACCTT
AGAGTGGCAAGCGCTC-1	AGAGTGGCAAGCGCTC
AGAGTGGGTAATTGGA-1	AGAGTGGGTAATTGGA
AGATCTGAGTGGTAGC-1	AGATCTGAGTGGTAGC
AGATCTGCATTGGGCC-1	AGATCTGCATTGGGCC
AGATTGCAGATGCGAC-1	AGATTGCAGATGCGAC
AGATTGCGTACTCTCC-1	AGATTGCGTACTCTCC
AGCCTAAAGGGTCGAT-1	AGCCTAAAGGGTCGAT
AGCCTAACATACGCTA-1	AGCCTAACATACGCTA
AGCCTAAGTTTGGCGC-1	AGCCTAAGTTTGGCGC
AGCGGTCGTCTCATCC-1	AGCGGTCGTCTCATCC
AGCGGTCGTGCCTGGT-1	AGCGGTCGTGCCTGGT
AGCGTATAGAACTGTA-1	AGCGTATAGAACTGTA
AGCGTATGTAGTACCT-1	AGCGTATGTAGTACCT
AGCGTCGCAAACTGCT-1	AGCGTCGCAAACTGCT
AGCGTCGGTTGCGCAC-1	AGCGTCGGTTGCGCAC
AGCTCCTGTCTCATCC-1	AGCTCCTGTCTCATCC
AGCTCCTTCAAGAAGT-1	AGCTCCTTCAAGAAGT
AGCTCCTTCATGTGGT-1	AGCTCCTTCATGTGGT
AGCTCCTTCCACGTTC-1	AGCTCCTTCCACGTTC
AGCTCTCCACCAACCG-1	AGCTCTCCACCAACCG
AGCTCTCTCTCTGCTG-1	AGCTCTCTCTCTGCTG
AGCTTGAGTACGAAAT-1	AGCTTGAGTACGAAAT
AGGCCACGTCTCCATC-1	AGGCCACGTCTCCATC
AGGCCACTCAGAGACG-1	AGGCCACTCAGAGACG
AGGCCGTAGATGTGTA-1	AGGCCGTAGATGTGTA
AGGCCGTAGTACGTAA-1	AGGCCGTAGTACGTAA
AGGCCGTCAGGGTACA-1	AGGCCGTCAGGGTACA
AGGCCGTTCCATGCTC-1	AGGCCGTTCCATGCTC
AGGGATGAGTGACATA-1	AGGGATGAGTGACATA
AGGGATGCAAGACGTG-1	AGGGATGCAAGACGTG
AGGGATGCATCCCATC-1	AGGGATGCATCCCATC
AGGGTGAAGGGCTTCC-1	AGGGTGAAGGGCTTCC
AGGTCATCACCGAATT-1	AGGTCATCACCGAATT
AGGTCATGTCTGCGGT-1	AGGTCATGTCTGCGGT
AGGTCCGCATGTAGTC-1	AGGTCCGCATGTAGTC
AGGTCCGGTTGTACAC-1	AGGTCCGGTTGTACAC
AGTAGTCAGTCTTGCA-1	AGTAGTCAGTCTTGCA
AGTCTTTCACCGGAAA-1	AGTCTTTCACCGGAAA
AGTCTTTGTTCATGGT-1	AGTCTTTGTTCATGGT
AGTGAGGAGACTAGGC-1	AGTGAGGAGACTAGGC
AGTGAGGCAATGGATA-1	AGTGAGGCAATGGATA
AGTGAGGGTTCCATGA-1	AGTGAGGGTTCCATGA
AGTGGGACAGCGATCC-1	AGTGGGACAGCGATCC
AGTGTCAAGGCCCTCA-1	AGTGTCAAGGCCCTCA
AGTGTCAAGTAGTGCG-1	AGTGTCAAGTAGTGCG
AGTGTCAGTCTAGTCA-1	AGTGTCAGTCTAGTCA
AGTTGGTCAATAAGCA-1	AGTTGGTCAATAAGCA
AGTTGGTGTTAGTGGG-1	AGTTGGTGTTAGTGGG
ATAACGCAGAGCCTAG-1	ATAACGCAGAGCCTAG
ATAAGAGGTACGAAAT-1	ATAAGAGGTACGAAAT
ATAAGAGGTGGGTATG-1	ATAAGAGGTGGGTATG
ATAAGAGTCGGGAGTA-1	ATAAGAGTCGGGAGTA
ATCACGAAGTGAACGC-1	ATCACGAAGTGAACGC
ATCATGGCATGACATC-1	ATCATGGCATGACATC
ATCGAGTCAAGCTGGA-1	ATCGAGTCAAGCTGGA
ATCGAGTCAATAGCGG-1	ATCGAGTCAATAGCGG
ATGCGATAGAGAACAG-1	ATGCGATAGAGAACAG
ATGCGATCATACGCCG-1	ATGCGATCATACGCCG
ATGCGATTCTGGCGTG-1	ATGCGATTCTGGCGTG
ATGGGAGCAGGCTCAC-1	ATGGGAGCAGGCTCAC
ATGGGAGCATACCATG-1	ATGGGAGCATACCATG
ATGTGTGAGCTGTCTA-1	ATGTGTGAGCTGTCTA
ATTACTCAGTGATCGG-1	ATTACTCAGTGATCGG
ATTACTCGTACCAGTT-1	ATTACTCGTACCAGTT
ATTATCCAGCTGAACG-1	ATTATCCAGCTGAACG
ATTATCCCACGTCTCT-1	ATTATCCCACGTCTCT
ATTCTACCAATAGAGT-1	ATTCTACCAATAGAGT
ATTCTACGTCTGATCA-1	ATTCTACGTCTGATCA
ATTGGACAGGAGTACC-1	ATTGGACAGGAGTACC
ATTGGACCAAGTCATC-1	ATTGGACCAAGTCATC
ATTGGACGTATATGAG-1	ATTGGACGTATATGAG
ATTGGTGCAGATGGCA-1	ATTGGTGCAGATGGCA
ATTGGTGGTGGTGTAG-1	ATTGGTGGTGGTGTAG
ATTGGTGTCATCATTC-1	ATTGGTGTCATCATTC
ATTTCTGAGTGCCAGA-1	ATTTCTGAGTGCCAGA
CAACCAACAATAGCAA-1	CAACCAACAATAGCAA
CAACCAACACCTCGTT-1	CAACCAACACCTCGTT
CAACCAATCAAAGTAG-1	CAACCAATCAAAGTAG
CAACCTCCAGGTGGAT-1	CAACCTCCAGGTGGAT
CAACCTCTCGATAGAA-1	CAACCTCTCGATAGAA
CAACTAGAGTGTACCT-1	CAACTAGAGTGTACCT
CAACTAGCAGCTGTTA-1	CAACTAGCAGCTGTTA
CAACTAGTCATGTGGT-1	CAACTAGTCATGTGGT
CAACTAGTCCGAAGAG-1	CAACTAGTCCGAAGAG
CAACTAGTCCGTCAAA-1	CAACTAGTCCGTCAAA
CAAGAAACAGTCGATT-1	CAAGAAACAGTCGATT
CAAGATCAGAAAGTGG-1	CAAGATCAGAAAGTGG
CAAGATCGTTCCAACA-1	CAAGATCGTTCCAACA
CAAGGCCGTACCTACA-1	CAAGGCCGTACCTACA
CAAGGCCGTCATCGGC-1	CAAGGCCGTCATCGGC
CAAGTTGAGAGGGATA-1	CAAGTTGAGAGGGATA
CAAGTTGGTTACTGAC-1	CAAGTTGGTTACTGAC
CAAGTTGTCACTTACT-1	CAAGTTGTCACTTACT
CACACAAAGCCACTAT-1	CACACAAAGCCACTAT
CACACAACACGACTCG-1	CACACAACACGACTCG
CACACAAGTGCGAAAC-1	CACACAAGTGCGAAAC
CACACCTAGCTAGCCC-1	CACACCTAGCTAGCCC
CACACCTAGGCATGGT-1	CACACCTAGGCATGGT
CACACCTCACGGCGTT-1	CACACCTCACGGCGTT
CACACCTGTAGCGTAG-1	CACACCTGTAGCGTAG
CACACCTGTCGACTAT-1	CACACCTGTCGACTAT
CACACTCCATACTCTT-1	CACACTCCATACTCTT
CACACTCGTACCGAGA-1	CACACTCGTACCGAGA
CACATAGGTGTGGCTC-1	CACATAGGTGTGGCTC
CACATAGTCCTTAATC-1	CACATAGTCCTTAATC
CACATTTCACCCTATC-1	CACATTTCACCCTATC
CACATTTCATCCAACA-1	CACATTTCATCCAACA
CACCACTAGTGCCATT-1	CACCACTAGTGCCATT
CACCAGGCAGATCCAT-1	CACCAGGCAGATCCAT
CACCAGGGTTGACGTT-1	CACCAGGGTTGACGTT
CACCAGGTCGCCATAA-1	CACCAGGTCGCCATAA
CACCTTGAGACCTTTG-1	CACCTTGAGACCTTTG
CACTCCACACGGACAA-1	CACTCCACACGGACAA
CACTCCACATTATCTC-1	CACTCCACATTATCTC
CACTCCAGTCCTCTTG-1	CACTCCAGTCCTCTTG
CAGAGAGCACATCCGG-1	CAGAGAGCACATCCGG
CAGAGAGTCAGCTCGG-1	CAGAGAGTCAGCTCGG
CAGCAGCGTGTTCGAT-1	CAGCAGCGTGTTCGAT
CAGCATATCATGTGGT-1	CAGCATATCATGTGGT
CAGCCGAAGGTAAACT-1	CAGCCGAAGGTAAACT
CAGCCGAGTCTAAACC-1	CAGCCGAGTCTAAACC
CAGCTAAGTGCACGAA-1	CAGCTAAGTGCACGAA
CAGCTAATCCTGCAGG-1	CAGCTAATCCTGCAGG
CAGGTGCAGAAGGACA-1	CAGGTGCAGAAGGACA
CAGGTGCCATCGGTTA-1	CAGGTGCCATCGGTTA
CAGGTGCGTCCAAGTT-1	CAGGTGCGTCCAAGTT
CAGGTGCTCGTATCAG-1	CAGGTGCTCGTATCAG
CAGTAACAGGGATCTG-1	CAGTAACAGGGATCTG
CAGTAACAGTGAAGAG-1	CAGTAACAGTGAAGAG
CAGTAACCAGTATGCT-1	CAGTAACCAGTATGCT
CAGTAACTCTTGCCGT-1	CAGTAACTCTTGCCGT
CATATTCCAGTAGAGC-1	CATATTCCAGTAGAGC
CATCAAGAGAGTTGGC-1	CATCAAGAGAGTTGGC
CATCAGAAGTGTACTC-1	CATCAGAAGTGTACTC
CATCAGAGTGTTCGAT-1	CATCAGAGTGTTCGAT
CATCAGATCCTTTCTC-1	CATCAGATCCTTTCTC
CATCAGATCGTACGGC-1	CATCAGATCGTACGGC
CATCCACAGGAGTAGA-1	CATCCACAGGAGTAGA
CATCCACCACCACCAG-1	CATCCACCACCACCAG
CATCCACCAGGATTGG-1	CATCCACCAGGATTGG
CATCCACTCAGCAACT-1	CATCCACTCAGCAACT
CATCGAACAATAAGCA-1	CATCGAACAATAAGCA
CATCGAACAGGTGCCT-1	CATCGAACAGGTGCCT
CATCGGGGTATTACCG-1	CATCGGGGTATTACCG
CATCGGGTCCACTGGG-1	CATCGGGTCCACTGGG
CATGACACAACCGCCA-1	CATGACACAACCGCCA
CATGCCTCACCTGGTG-1	CATGCCTCACCTGGTG
CATGCCTGTGCCTGGT-1	CATGCCTGTGCCTGGT
CATGCCTTCCGATATG-1	CATGCCTTCCGATATG
CATGCCTTCTTGCATT-1	CATGCCTTCTTGCATT
CATGGCGTCACTATTC-1	CATGGCGTCACTATTC
CATGGCGTCTGGTGTA-1	CATGGCGTCTGGTGTA
CATTATCCAACCGCCA-1	CATTATCCAACCGCCA
CATTATCGTCGCTTTC-1	CATTATCGTCGCTTTC
CATTCGCAGAGCTTCT-1	CATTCGCAGAGCTTCT
CATTCGCCAAAGTCAA-1	CATTCGCCAAAGTCAA
CATTCGCCAGTGAGTG-1	CATTCGCCAGTGAGTG
CCAATCCGTGGTCTCG-1	CCAATCCGTGGTCTCG
CCACGGAAGGTTACCT-1	CCACGGAAGGTTACCT
CCACGGATCCTTGCCA-1	CCACGGATCCTTGCCA
CCACGGATCTCTAAGG-1	CCACGGATCTCTAAGG
CCACTACCATAGGATA-1	CCACTACCATAGGATA
CCAGCGATCCAGTATG-1	CCAGCGATCCAGTATG
CCATGTCAGTGTCTCA-1	CCATGTCAGTGTCTCA
CCATGTCCACCTCGTT-1	CCATGTCCACCTCGTT
CCATGTCCATCAGTCA-1	CCATGTCCATCAGTCA
CCATGTCCATGGAATA-1	CCATGTCCATGGAATA
CCATGTCGTTTGACTG-1	CCATGTCGTTTGACTG
CCATTCGAGCTACCTA-1	CCATTCGAGCTACCTA
CCATTCGAGGATGTAT-1	CCATTCGAGGATGTAT
CCATTCGGTCAAAGAT-1	CCATTCGGTCAAAGAT
CCATTCGTCACCCGAG-1	CCATTCGTCACCCGAG
CCATTCGTCTGGTATG-1	CCATTCGTCTGGTATG
CCCAATCAGGTGATTA-1	CCCAATCAGGTGATTA
CCCAATCAGTGTCCCG-1	CCCAATCAGTGTCCCG
CCCAATCGTCAGAGGT-1	CCCAATCGTCAGAGGT
CCCAATCGTTCGTGAT-1	CCCAATCGTTCGTGAT
CCCAATCGTTGGTGGA-1	CCCAATCGTTGGTGGA
CCCAGTTAGGCTAGGT-1	CCCAGTTAGGCTAGGT
CCCTCCTCATTATCTC-1	CCCTCCTCATTATCTC
CCCTCCTGTTGGACCC-1	CCCTCCTGTTGGACCC
CCCTCCTTCTCCTATA-1	CCCTCCTTCTCCTATA
CCGGGATAGACCCACC-1	CCGGGATAGACCCACC
CCGGGATAGCGATTCT-1	CCGGGATAGCGATTCT
CCGGGATAGTGAAGAG-1	CCGGGATAGTGAAGAG
CCGTACTTCACAACGT-1	CCGTACTTCACAACGT
CCGTGGAGTCGGCTCA-1	CCGTGGAGTCGGCTCA
CCGTTCATCGGCATCG-1	CCGTTCATCGGCATCG
CCTAAAGGTTGGGACA-1	CCTAAAGGTTGGGACA
CCTACACCATGGTAGG-1	CCTACACCATGGTAGG
CCTACACTCACGATGT-1	CCTACACTCACGATGT
CCTACCACATCCCATC-1	CCTACCACATCCCATC
CCTACCATCGGAAACG-1	CCTACCATCGGAAACG
CCTAGCTAGAGTGAGA-1	CCTAGCTAGAGTGAGA
CCTAGCTCAGGTCTCG-1	CCTAGCTCAGGTCTCG
CCTCAGTCACAAGTAA-1	CCTCAGTCACAAGTAA
CCTCAGTGTAGCGTGA-1	CCTCAGTGTAGCGTGA
CCTCTGATCTAACCGA-1	CCTCTGATCTAACCGA
CCTTACGAGACAGGCT-1	CCTTACGAGACAGGCT
CCTTACGGTAGCACGA-1	CCTTACGGTAGCACGA
CCTTCGAAGCGAGAAA-1	CCTTCGAAGCGAGAAA
CCTTCGAAGCTAACAA-1	CCTTCGAAGCTAACAA
CCTTCGAAGGAGTACC-1	CCTTCGAAGGAGTACC
CCTTCGACAGTGAGTG-1	CCTTCGACAGTGAGTG
CCTTCGACATGTAGTC-1	CCTTCGACATGTAGTC
CCTTTCTGTCGGATCC-1	CCTTTCTGTCGGATCC
CGAACATAGGATGCGT-1	CGAACATAGGATGCGT
CGAACATCACTACAGT-1	CGAACATCACTACAGT
CGAACATCATGCATGT-1	CGAACATCATGCATGT
CGACTTCCATAGACTC-1	CGACTTCCATAGACTC
CGACTTCTCCTGCAGG-1	CGACTTCTCCTGCAGG
CGAGAAGAGCACCGCT-1	CGAGAAGAGCACCGCT
CGAGAAGTCGAACTGT-1	CGAGAAGTCGAACTGT
CGAGCACTCGTGGACC-1	CGAGCACTCGTGGACC
CGATCGGAGCTCCCAG-1	CGATCGGAGCTCCCAG
CGATCGGGTCGCCATG-1	CGATCGGGTCGCCATG
CGATCGGTCAGCTGGC-1	CGATCGGTCAGCTGGC
CGATGGCAGAAGGCCT-1	CGATGGCAGAAGGCCT
CGATGGCGTAACGTTC-1	CGATGGCGTAACGTTC
CGATGTAGTCGACTAT-1	CGATGTAGTCGACTAT
CGATTGAAGATATACG-1	CGATTGAAGATATACG
CGATTGAAGTGTGAAT-1	CGATTGAAGTGTGAAT
CGATTGATCCAAACTG-1	CGATTGATCCAAACTG
CGCCAAGCAGGTGCCT-1	CGCCAAGCAGGTGCCT
CGCCAAGGTCTCTCGT-1	CGCCAAGGTCTCTCGT
CGCCAAGGTCTTGCGG-1	CGCCAAGGTCTTGCGG
CGCCAAGGTGATGATA-1	CGCCAAGGTGATGATA
CGCCAAGTCTTGTCAT-1	CGCCAAGTCTTGTCAT
CGCGGTACAAGAGGCT-1	CGCGGTACAAGAGGCT
CGCTATCGTGGTGTAG-1	CGCTATCGTGGTGTAG
CGCTATCTCATCTGTT-1	CGCTATCTCATCTGTT
CGCTGGATCAACGGGA-1	CGCTGGATCAACGGGA
CGCTGGATCTGTCAAG-1	CGCTGGATCTGTCAAG
CGGACACCACAGGCCT-1	CGGACACCACAGGCCT
CGGACGTAGACTACAA-1	CGGACGTAGACTACAA
CGGACGTCACAAGACG-1	CGGACGTCACAAGACG
CGGACGTTCCTCAACC-1	CGGACGTTCCTCAACC
CGGACTGAGTGACTCT-1	CGGACTGAGTGACTCT
CGGACTGCAGTTTACG-1	CGGACTGCAGTTTACG
CGGACTGTCGCATGGC-1	CGGACTGTCGCATGGC
CGGAGCTAGCCACGCT-1	CGGAGCTAGCCACGCT
CGGAGTCCATGTTGAC-1	CGGAGTCCATGTTGAC
CGGCTAGGTGAGGGTT-1	CGGCTAGGTGAGGGTT
CGGCTAGTCACAATGC-1	CGGCTAGTCACAATGC
CGGCTAGTCATTCACT-1	CGGCTAGTCATTCACT
CGGCTAGTCCCAAGAT-1	CGGCTAGTCCCAAGAT
CGGGTCACATGGTCAT-1	CGGGTCACATGGTCAT
CGGGTCAGTGTGAAAT-1	CGGGTCAGTGTGAAAT
CGGTTAACACTTAAGC-1	CGGTTAACACTTAAGC
CGTAGGCTCATGCATG-1	CGTAGGCTCATGCATG
CGTCACTTCCTTTACA-1	CGTCACTTCCTTTACA
CGTCAGGAGATCCCGC-1	CGTCAGGAGATCCCGC
CGTCAGGCATCTATGG-1	CGTCAGGCATCTATGG
CGTCCATTCTACCTGC-1	CGTCCATTCTACCTGC
CGTGAGCAGCGAGAAA-1	CGTGAGCAGCGAGAAA
CGTGAGCTCTGTCTAT-1	CGTGAGCTCTGTCTAT
CGTGTCTAGAACTGTA-1	CGTGTCTAGAACTGTA
CGTGTCTAGGGCTTGA-1	CGTGTCTAGGGCTTGA
CGTGTCTAGTAAGTAC-1	CGTGTCTAGTAAGTAC
CGTGTCTCATCCGTGG-1	CGTGTCTCATCCGTGG
CGTGTCTGTAGAGTGC-1	CGTGTCTGTAGAGTGC
CGTTAGACACAGGCCT-1	CGTTAGACACAGGCCT
CGTTGGGCAGCCTGTG-1	CGTTGGGCAGCCTGTG
CTAAGACAGCTGATAA-1	CTAAGACAGCTGATAA
CTAAGACTCCTGCCAT-1	CTAAGACTCCTGCCAT
CTACACCCAAGGACAC-1	CTACACCCAAGGACAC
CTACATTTCCTCATTA-1	CTACATTTCCTCATTA
CTACCCAGTACTTGAC-1	CTACCCAGTACTTGAC
CTACGTCAGGATTCGG-1	CTACGTCAGGATTCGG
CTACGTCCATGCTAGT-1	CTACGTCCATGCTAGT
CTACGTCCATGGGACA-1	CTACGTCCATGGGACA
CTACGTCGTCGAGTTT-1	CTACGTCGTCGAGTTT
CTAGAGTTCGCCGTGA-1	CTAGAGTTCGCCGTGA
CTAGTGAAGCCACGCT-1	CTAGTGAAGCCACGCT
CTAGTGACAACTGCGC-1	CTAGTGACAACTGCGC
CTAGTGACAAGTCATC-1	CTAGTGACAAGTCATC
CTAGTGACAATAACGA-1	CTAGTGACAATAACGA
CTCACACAGCTGTCTA-1	CTCACACAGCTGTCTA
CTCACACAGGGCATGT-1	CTCACACAGGGCATGT
CTCACACAGTCAATAG-1	CTCACACAGTCAATAG
CTCACACTCTGCAAGT-1	CTCACACTCTGCAAGT
CTCAGAATCGTTTAGG-1	CTCAGAATCGTTTAGG
CTCATTACACATCTTT-1	CTCATTACACATCTTT
CTCATTACATTCTCAT-1	CTCATTACATTCTCAT
CTCATTAGTCCATCCT-1	CTCATTAGTCCATCCT
CTCATTATCGGTGTCG-1	CTCATTATCGGTGTCG
CTCATTATCGTTGCCT-1	CTCATTATCGTTGCCT
CTCCTAGCAGACGCCT-1	CTCCTAGCAGACGCCT
CTCGAGGCACAAGTAA-1	CTCGAGGCACAAGTAA
CTCGAGGGTTGAGGTG-1	CTCGAGGGTTGAGGTG
CTCGGAGAGACATAAC-1	CTCGGAGAGACATAAC
CTCGGAGAGGAACTGC-1	CTCGGAGAGGAACTGC
CTCGGAGTCACCAGGC-1	CTCGGAGTCACCAGGC
CTCGGAGTCCACTGGG-1	CTCGGAGTCCACTGGG
CTCGGGAGTGCACCAC-1	CTCGGGAGTGCACCAC
CTCGTACCAGACGCAA-1	CTCGTACCAGACGCAA
CTCGTACTCAGCTCTC-1	CTCGTACTCAGCTCTC
CTCGTCACAGACAAGC-1	CTCGTCACAGACAAGC
CTCGTCAGTATTCGTG-1	CTCGTCAGTATTCGTG
CTCGTCAGTCGCGAAA-1	CTCGTCAGTCGCGAAA
CTCGTCATCGTTACGA-1	CTCGTCATCGTTACGA
CTCTAATGTCCGTGAC-1	CTCTAATGTCCGTGAC
CTCTACGGTATCAGTC-1	CTCTACGGTATCAGTC
CTCTACGGTTCCGTCT-1	CTCTACGGTTCCGTCT
CTCTACGGTTGCCTCT-1	CTCTACGGTTGCCTCT
CTCTGGTCAGATGAGC-1	CTCTGGTCAGATGAGC
CTCTGGTCAGCTCCGA-1	CTCTGGTCAGCTCCGA
CTCTGGTCATCTCCCA-1	CTCTGGTCATCTCCCA
CTCTGGTTCCTAGTGA-1	CTCTGGTTCCTAGTGA
CTGAAACTCAACGGCC-1	CTGAAACTCAACGGCC
CTGAAGTGTTAGTGGG-1	CTGAAGTGTTAGTGGG
CTGAAGTGTTGGACCC-1	CTGAAGTGTTGGACCC
CTGATAGCAGCTGCTG-1	CTGATAGCAGCTGCTG
CTGATAGTCTTGCCGT-1	CTGATAGTCTTGCCGT
CTGATCCCAAACCCAT-1	CTGATCCCAAACCCAT
CTGCCTACAAACGCGA-1	CTGCCTACAAACGCGA
CTGCCTAGTCGCATAT-1	CTGCCTAGTCGCATAT
CTGCCTAGTCGCCATG-1	CTGCCTAGTCGCCATG
CTGCCTAGTTGTCTTT-1	CTGCCTAGTTGTCTTT
CTGCGGAAGGATTCGG-1	CTGCGGAAGGATTCGG
CTGCGGAAGTTCGCGC-1	CTGCGGAAGTTCGCGC
CTGCGGACAGCTGCTG-1	CTGCGGACAGCTGCTG
CTGCGGACAGTGACAG-1	CTGCGGACAGTGACAG
CTGCTGTAGAAAGTGG-1	CTGCTGTAGAAAGTGG
CTGCTGTGTATCAGTC-1	CTGCTGTGTATCAGTC
CTGCTGTTCTAACTCT-1	CTGCTGTTCTAACTCT
CTGCTGTTCTCGGACG-1	CTGCTGTTCTCGGACG
CTGCTGTTCTGTTTGT-1	CTGCTGTTCTGTTTGT
CTGGTCTAGTGTGGCA-1	CTGGTCTAGTGTGGCA
CTGTGCTGTACCAGTT-1	CTGTGCTGTACCAGTT
CTGTTTACAAAGCGGT-1	CTGTTTACAAAGCGGT
CTGTTTACACATGACT-1	CTGTTTACACATGACT
CTTAACTAGACTAGGC-1	CTTAACTAGACTAGGC
CTTAACTAGGAGTACC-1	CTTAACTAGGAGTACC
CTTAACTCATTTCAGG-1	CTTAACTCATTTCAGG
CTTAACTTCCCGGATG-1	CTTAACTTCCCGGATG
CTTACCGTCGTACCGG-1	CTTACCGTCGTACCGG
CTTAGGAAGTCGAGTG-1	CTTAGGAAGTCGAGTG
CTTAGGACAATTGCTG-1	CTTAGGACAATTGCTG
CTTCTCTAGAGGGATA-1	CTTCTCTAGAGGGATA
CTTGGCTCAGGAATCG-1	CTTGGCTCAGGAATCG
CTTGGCTCATCGTCGG-1	CTTGGCTCATCGTCGG
CTTGGCTGTCTCTCTG-1	CTTGGCTGTCTCTCTG
CTTGGCTTCCTTGACC-1	CTTGGCTTCCTTGACC
CTTTGCGAGCGATGAC-1	CTTTGCGAGCGATGAC
GAAACTCCATCGGGTC-1	GAAACTCCATCGGGTC
GAAATGACATCGGGTC-1	GAAATGACATCGGGTC
GAAATGAGTGAAATCA-1	GAAATGAGTGAAATCA
GAAATGAGTGCAGTAG-1	GAAATGAGTGCAGTAG
GAACATCAGCCGATTT-1	GAACATCAGCCGATTT
GAACATCAGTTAAGTG-1	GAACATCAGTTAAGTG
GAACATCCACAGTCGC-1	GAACATCCACAGTCGC
GAACATCTCCGCGGTA-1	GAACATCTCCGCGGTA
GAACCTATCACATACG-1	GAACCTATCACATACG
GAACGGACACATCCAA-1	GAACGGACACATCCAA
GAACGGAGTGAGGCTA-1	GAACGGAGTGAGGCTA
GAACGGAGTGCAGACA-1	GAACGGAGTGCAGACA
GAAGCAGAGCACCGCT-1	GAAGCAGAGCACCGCT
GAAGCAGAGCCGGTAA-1	GAAGCAGAGCCGGTAA
GAAGCAGCATGTAAGA-1	GAAGCAGCATGTAAGA
GAATAAGAGAACAATC-1	GAATAAGAGAACAATC
GAATAAGAGGGTGTGT-1	GAATAAGAGGGTGTGT
GAATAAGAGTGTGAAT-1	GAATAAGAGTGTGAAT
GAATAAGCAAAGGTGC-1	GAATAAGCAAAGGTGC
GAATAAGCAATTCCTT-1	GAATAAGCAATTCCTT
GAATGAACACGTCAGC-1	GAATGAACACGTCAGC
GACAGAGAGATCCCGC-1	GACAGAGAGATCCCGC
GACAGAGAGCTGATAA-1	GACAGAGAGCTGATAA
GACAGAGCAATAACGA-1	GACAGAGCAATAACGA
GACAGAGCACACATGT-1	GACAGAGCACACATGT
GACAGAGGTAGCGTCC-1	GACAGAGGTAGCGTCC
GACAGAGGTCTAAAGA-1	GACAGAGGTCTAAAGA
GACCAATCATCGTCGG-1	GACCAATCATCGTCGG
GACCTGGAGGCGTACA-1	GACCTGGAGGCGTACA
GACCTGGGTGTCGCTG-1	GACCTGGGTGTCGCTG
GACGCGTCAGACACTT-1	GACGCGTCAGACACTT
GACGCGTCATTCCTCG-1	GACGCGTCATTCCTCG
GACGGCTTCTTAGCCC-1	GACGGCTTCTTAGCCC
GACGTGCCAATAGAGT-1	GACGTGCCAATAGAGT
GACGTGCTCATCGATG-1	GACGTGCTCATCGATG
GACGTTAGTGCCTGTG-1	GACGTTAGTGCCTGTG
GACTAACAGCAATCTC-1	GACTAACAGCAATCTC
GACTAACGTTTCGCTC-1	GACTAACGTTTCGCTC
GACTACAGTTATTCTC-1	GACTACAGTTATTCTC
GACTGCGAGATGGCGT-1	GACTGCGAGATGGCGT
GACTGCGAGTTAAGTG-1	GACTGCGAGTTAAGTG
GACTGCGCAATAGAGT-1	GACTGCGCAATAGAGT
GACTGCGGTCACAAGG-1	GACTGCGGTCACAAGG
GAGCAGAAGACAGACC-1	GAGCAGAAGACAGACC
GAGCAGACACGCTTTC-1	GAGCAGACACGCTTTC
GAGGTGACATCCGCGA-1	GAGGTGACATCCGCGA
GAGGTGAGTCTCGTTC-1	GAGGTGAGTCTCGTTC
GATCAGTAGATGTGGC-1	GATCAGTAGATGTGGC
GATCAGTGTAAGGGAA-1	GATCAGTGTAAGGGAA
GATCAGTGTCACCCAG-1	GATCAGTGTCACCCAG
GATCAGTGTTATCGGT-1	GATCAGTGTTATCGGT
GATCGATAGACTTGAA-1	GATCGATAGACTTGAA
GATCGATAGTCGTACT-1	GATCGATAGTCGTACT
GATCGATGTAAGTTCC-1	GATCGATGTAAGTTCC
GATCGATGTTCGTCTC-1	GATCGATGTTCGTCTC
GATCGCGAGGATGGTC-1	GATCGCGAGGATGGTC
GATCGTATCATGCAAC-1	GATCGTATCATGCAAC
GATCTAGCAAGTAGTA-1	GATCTAGCAAGTAGTA
GATGAAAAGTCTCGGC-1	GATGAAAAGTCTCGGC
GATGAAAGTATCTGCA-1	GATGAAAGTATCTGCA
GATGCTAGTCGAAAGC-1	GATGCTAGTCGAAAGC
GATGCTATCTCGCATC-1	GATGCTATCTCGCATC
GATTCAGAGTGTCTCA-1	GATTCAGAGTGTCTCA
GATTCAGTCCAAATGC-1	GATTCAGTCCAAATGC
GCAAACTAGAATGTTG-1	GCAAACTAGAATGTTG
GCAAACTAGACCTTTG-1	GCAAACTAGACCTTTG
GCAAACTCATCGTCGG-1	GCAAACTCATCGTCGG
GCAAACTTCGAATGGG-1	GCAAACTTCGAATGGG
GCAATCACAATGGAGC-1	GCAATCACAATGGAGC
GCAATCAGTACACCGC-1	GCAATCAGTACACCGC
GCAATCAGTTGCGCAC-1	GCAATCAGTTGCGCAC
GCACTCTTCACCATAG-1	GCACTCTTCACCATAG
GCAGCCACAGGGTATG-1	GCAGCCACAGGGTATG
GCAGCCAGTCCGTCAG-1	GCAGCCAGTCCGTCAG
GCAGTTAAGTGTCCAT-1	GCAGTTAAGTGTCCAT
GCAGTTAAGTTACGGG-1	GCAGTTAAGTTACGGG
GCATACACACGGCTAC-1	GCATACACACGGCTAC
GCATGCGAGTCAATAG-1	GCATGCGAGTCAATAG
GCATGCGGTGCCTGCA-1	GCATGCGGTGCCTGCA
GCATGCGTCGAGAGCA-1	GCATGCGTCGAGAGCA
GCATGTAAGCTAGTCT-1	GCATGTAAGCTAGTCT
GCATGTAAGTTATCGC-1	GCATGTAAGTTATCGC
GCCTCTAAGTAATCCC-1	GCCTCTAAGTAATCCC
GCCTCTAGTAGCGTAG-1	GCCTCTAGTAGCGTAG
GCCTCTAGTTACCGAT-1	GCCTCTAGTTACCGAT
GCGACCAAGACCCACC-1	GCGACCAAGACCCACC
GCGACCAGTACACCGC-1	GCGACCAGTACACCGC
GCGACCATCGGATGGA-1	GCGACCATCGGATGGA
GCGAGAAAGCTTCGCG-1	GCGAGAAAGCTTCGCG
GCGCAACGTGCGAAAC-1	GCGCAACGTGCGAAAC
GCGCAGTGTGGGTCAA-1	GCGCAGTGTGGGTCAA
GCGCCAAAGCTCTCGG-1	GCGCCAAAGCTCTCGG
GCGCCAACATAGAAAC-1	GCGCCAACATAGAAAC
GCGCCAACATAGACTC-1	GCGCCAACATAGACTC
GCGCCAAGTCAACATC-1	GCGCCAAGTCAACATC
GCGCCAATCCCGGATG-1	GCGCCAATCCCGGATG
GCGCGATAGGCAGTCA-1	GCGCGATAGGCAGTCA
GCGCGATGTGTTGAGG-1	GCGCGATGTGTTGAGG
GCGGGTTCAAGCCTAT-1	GCGGGTTCAAGCCTAT
GCGGGTTCAGGTTTCA-1	GCGGGTTCAGGTTTCA
GCGGGTTTCACATAGC-1	GCGGGTTTCACATAGC
GCGGGTTTCTGAGGGA-1	GCGGGTTTCTGAGGGA
GCTCCTAAGTAGCCGA-1	GCTCCTAAGTAGCCGA
GCTCCTAGTCATCGGC-1	GCTCCTAGTCATCGGC
GCTCTGTGTGGTGTAG-1	GCTCTGTGTGGTGTAG
GCTCTGTTCGTAGGTT-1	GCTCTGTTCGTAGGTT
GCTGCAGAGCCAGGAT-1	GCTGCAGAGCCAGGAT
GCTGCAGAGTATTGGA-1	GCTGCAGAGTATTGGA
GCTGCAGGTTCGGCAC-1	GCTGCAGGTTCGGCAC
GCTGCGATCCGCTGTT-1	GCTGCGATCCGCTGTT
GCTGCTTCACACCGCA-1	GCTGCTTCACACCGCA
GCTGCTTCAGGTCCAC-1	GCTGCTTCAGGTCCAC
GCTGGGTAGGCAGTCA-1	GCTGGGTAGGCAGTCA
GCTGGGTAGTCATCCA-1	GCTGGGTAGTCATCCA
GCTGGGTGTCTAACGT-1	GCTGGGTGTCTAACGT
GCTTCCATCGCGTTTC-1	GCTTCCATCGCGTTTC
GCTTGAAAGTAGATGT-1	GCTTGAAAGTAGATGT
GCTTGAAAGTCAAGCG-1	GCTTGAAAGTCAAGCG
GCTTGAACAACTGCTA-1	GCTTGAACAACTGCTA
GCTTGAAGTTTCGCTC-1	GCTTGAAGTTTCGCTC
GGAAAGCGTCACTTCC-1	GGAAAGCGTCACTTCC
GGAAAGCTCGGCTTGG-1	GGAAAGCTCGGCTTGG
GGAACTTCACTGTGTA-1	GGAACTTCACTGTGTA
GGAATAACAGTCTTCC-1	GGAATAACAGTCTTCC
GGAATAAGTGGTGTAG-1	GGAATAAGTGGTGTAG
GGAATAATCAGGCGAA-1	GGAATAATCAGGCGAA
GGACAAGTCCACGTTC-1	GGACAAGTCCACGTTC
GGACAGAGTGTTGGGA-1	GGACAGAGTGTTGGGA
GGACATTAGTGAACAT-1	GGACATTAGTGAACAT
GGACGTCTCTGGAGCC-1	GGACGTCTCTGGAGCC
GGAGCAAAGGATTCGG-1	GGAGCAAAGGATTCGG
GGAGCAAGTCAACATC-1	GGAGCAAGTCAACATC
GGAGCAAGTGGACGAT-1	GGAGCAAGTGGACGAT
GGATTACGTTCCCTTG-1	GGATTACGTTCCCTTG
GGCAATTAGCGTTGCC-1	GGCAATTAGCGTTGCC
GGCAATTGTATGAATG-1	GGCAATTGTATGAATG
GGCAATTGTGGTCTCG-1	GGCAATTGTGGTCTCG
GGCCGATAGTGACATA-1	GGCCGATAGTGACATA
GGCCGATGTGACGGTA-1	GGCCGATGTGACGGTA
GGCCGATTCATGTAGC-1	GGCCGATTCATGTAGC
GGCCGATTCGCGGATC-1	GGCCGATTCGCGGATC
GGCTGGTCATCACGTA-1	GGCTGGTCATCACGTA
GGGAATGGTCTCCCTA-1	GGGAATGGTCTCCCTA
GGGAATGGTGGCGAAT-1	GGGAATGGTGGCGAAT
GGGACCTCAAGACACG-1	GGGACCTCAAGACACG
GGGACCTTCTGAGGGA-1	GGGACCTTCTGAGGGA
GGGAGATAGACTCGGA-1	GGGAGATAGACTCGGA
GGGATGATCGGAGGTA-1	GGGATGATCGGAGGTA
GGGCACTAGGATATAC-1	GGGCACTAGGATATAC
GGGCACTAGGGTCTCC-1	GGGCACTAGGGTCTCC
GGGCACTAGTGTGAAT-1	GGGCACTAGTGTGAAT
GGGCACTCAGCTCGCA-1	GGGCACTCAGCTCGCA
GGGCACTGTAGCGTAG-1	GGGCACTGTAGCGTAG
GGGCACTGTTACGACT-1	GGGCACTGTTACGACT
GGGTCTGCACATAACC-1	GGGTCTGCACATAACC
GGGTTGCAGCCCAATT-1	GGGTTGCAGCCCAATT
GGGTTGCAGTTAAGTG-1	GGGTTGCAGTTAAGTG
GGGTTGCCAGCTTAAC-1	GGGTTGCCAGCTTAAC
GGGTTGCCATCCGCGA-1	GGGTTGCCATCCGCGA
GGGTTGCCATGCAACT-1	GGGTTGCCATGCAACT
GGGTTGCTCGTATCAG-1	GGGTTGCTCGTATCAG
GGTATTGGTACAGTTC-1	GGTATTGGTACAGTTC
GGTATTGGTGTGTGCC-1	GGTATTGGTGTGTGCC
GGTGAAGCAGACAAAT-1	GGTGAAGCAGACAAAT
GGTGCGTGTGACGGTA-1	GGTGCGTGTGACGGTA
GGTGTTAAGAGGTTGC-1	GGTGTTAAGAGGTTGC
GGTGTTAAGCCCAGCT-1	GGTGTTAAGCCCAGCT
GGTGTTAGTCTTGTCC-1	GGTGTTAGTCTTGTCC
GTAACGTGTCTCACCT-1	GTAACGTGTCTCACCT
GTAACGTGTTAAGATG-1	GTAACGTGTTAAGATG
GTAACTGAGCTACCTA-1	GTAACTGAGCTACCTA
GTAACTGTCACGCGGT-1	GTAACTGTCACGCGGT
GTAACTGTCCAAATGC-1	GTAACTGTCCAAATGC
GTACGTAAGATCTGAA-1	GTACGTAAGATCTGAA
GTACGTAGTCTTCAAG-1	GTACGTAGTCTTCAAG
GTACGTAGTTCCCGAG-1	GTACGTAGTTCCCGAG
GTACGTATCTACTTAC-1	GTACGTATCTACTTAC
GTACTCCTCAGTTTGG-1	GTACTCCTCAGTTTGG
GTACTCCTCCTCGCAT-1	GTACTCCTCCTCGCAT
GTAGGCCCAAGTCATC-1	GTAGGCCCAAGTCATC
GTAGGCCGTCTCTTTA-1	GTAGGCCGTCTCTTTA
GTAGGCCTCGGAAATA-1	GTAGGCCTCGGAAATA
GTAGTCAGTATTACCG-1	GTAGTCAGTATTACCG
GTATCTTAGAGTAATC-1	GTATCTTAGAGTAATC
GTATTCTAGTTACGGG-1	GTATTCTAGTTACGGG
GTCAAGTTCTCGCATC-1	GTCAAGTTCTCGCATC
GTCACAACAAGCTGAG-1	GTCACAACAAGCTGAG
GTCATTTAGTGGAGAA-1	GTCATTTAGTGGAGAA
GTCATTTTCACAATGC-1	GTCATTTTCACAATGC
GTCCTCACATCCTTGC-1	GTCCTCACATCCTTGC
GTCCTCAGTTTAGGAA-1	GTCCTCAGTTTAGGAA
GTCGGGTCAGCCTATA-1	GTCGGGTCAGCCTATA
GTCGGGTGTGTTTGGT-1	GTCGGGTGTGTTTGGT
GTCGTAACAAGCCATT-1	GTCGTAACAAGCCATT
GTCGTAATCACAGGCC-1	GTCGTAATCACAGGCC
GTCTCGTAGCCGGTAA-1	GTCTCGTAGCCGGTAA
GTCTCGTCATGCAACT-1	GTCTCGTCATGCAACT
GTCTCGTGTTTAGGAA-1	GTCTCGTGTTTAGGAA
GTCTTCGAGCGGATCA-1	GTCTTCGAGCGGATCA
GTCTTCGAGTCCGTAT-1	GTCTTCGAGTCCGTAT
GTGCAGCGTAGAAAGG-1	GTGCAGCGTAGAAAGG
GTGCAGCGTTCGCGAC-1	GTGCAGCGTTCGCGAC
GTGCATAAGAAGGTGA-1	GTGCATAAGAAGGTGA
GTGCATAAGGCCATAG-1	GTGCATAAGGCCATAG
GTGCATACATAGGATA-1	GTGCATACATAGGATA
GTGCATAGTCCCGACA-1	GTGCATAGTCCCGACA
GTGCTTCAGAACTCGG-1	GTGCTTCAGAACTCGG
GTGCTTCCAGTACACT-1	GTGCTTCCAGTACACT
GTGCTTCTCACTATTC-1	GTGCTTCTCACTATTC
GTGGGTCTCAGCTCGG-1	GTGGGTCTCAGCTCGG
GTGTTAGAGAGACGAA-1	GTGTTAGAGAGACGAA
GTGTTAGGTACTCGCG-1	GTGTTAGGTACTCGCG
GTTAAGCAGTTCGCAT-1	GTTAAGCAGTTCGCAT
GTTAAGCGTAAAGTCA-1	GTTAAGCGTAAAGTCA
GTTAAGCGTTACGGAG-1	GTTAAGCGTTACGGAG
GTTCATTAGCGTAGTG-1	GTTCATTAGCGTAGTG
GTTCATTAGTACGTAA-1	GTTCATTAGTACGTAA
GTTCATTGTACACCGC-1	GTTCATTGTACACCGC
GTTCATTGTTCTGGTA-1	GTTCATTGTTCTGGTA
GTTCGGGGTTCATGGT-1	GTTCGGGGTTCATGGT
GTTCTCGCACGGTTTA-1	GTTCTCGCACGGTTTA
GTTCTCGGTTATCACG-1	GTTCTCGGTTATCACG
GTTCTCGGTTCTGGTA-1	GTTCTCGGTTCTGGTA
GTTCTCGTCACATGCA-1	GTTCTCGTCACATGCA
GTTTCTAAGTACGCCC-1	GTTTCTAAGTACGCCC
GTTTCTATCGTATCAG-1	GTTTCTATCGTATCAG
TAAACCGAGCGTAATA-1	TAAACCGAGCGTAATA
TAAACCGAGGCCGAAT-1	TAAACCGAGGCCGAAT
TAAACCGCAGCTGCTG-1	TAAACCGCAGCTGCTG
TAAGCGTAGAGTCGGT-1	TAAGCGTAGAGTCGGT
TAAGCGTTCACTCCTG-1	TAAGCGTTCACTCCTG
TAAGCGTTCATCGCTC-1	TAAGCGTTCATCGCTC
TAAGCGTTCTGTCCGT-1	TAAGCGTTCTGTCCGT
TAAGTGCAGACTGTAA-1	TAAGTGCAGACTGTAA
TAAGTGCAGCGCTTAT-1	TAAGTGCAGCGCTTAT
TAAGTGCCACACTGCG-1	TAAGTGCCACACTGCG
TACCTATTCACAATGC-1	TACCTATTCACAATGC
TACCTTAAGACCTTTG-1	TACCTTAAGACCTTTG
TACCTTAGTGACAAAT-1	TACCTTAGTGACAAAT
TACGGATCAATAACGA-1	TACGGATCAATAACGA
TACGGATGTCCCTACT-1	TACGGATGTCCCTACT
TACGGATTCGATCCCT-1	TACGGATTCGATCCCT
TACGGTAGTAACGACG-1	TACGGTAGTAACGACG
TACGGTAGTAGCAAAT-1	TACGGTAGTAGCAAAT
TACGGTATCAATCACG-1	TACGGTATCAATCACG
TACTCATAGCAAATCA-1	TACTCATAGCAAATCA
TACTCATCATAAGACA-1	TACTCATCATAAGACA
TACTCATGTTTCCACC-1	TACTCATGTTTCCACC
TACTCGCGTTCAACCA-1	TACTCGCGTTCAACCA
TACTTACTCACTATTC-1	TACTTACTCACTATTC
TAGAGCTGTCGAAAGC-1	TAGAGCTGTCGAAAGC
TAGAGCTGTTCTGGTA-1	TAGAGCTGTTCTGGTA
TAGAGCTTCCGCATAA-1	TAGAGCTTCCGCATAA
TAGCCGGAGCAGGTCA-1	TAGCCGGAGCAGGTCA
TAGCCGGCATGGGAAC-1	TAGCCGGCATGGGAAC
TAGCCGGGTAGCTTGT-1	TAGCCGGGTAGCTTGT
TAGGCATAGGACAGCT-1	TAGGCATAGGACAGCT
TAGGCATGTCGCGTGT-1	TAGGCATGTCGCGTGT
TAGGCATTCTAACCGA-1	TAGGCATTCTAACCGA
TAGTGGTAGCGTAGTG-1	TAGTGGTAGCGTAGTG
TAGTTGGAGCTAGTTC-1	TAGTTGGAGCTAGTTC
TAGTTGGAGTTCGATC-1	TAGTTGGAGTTCGATC
TAGTTGGGTAGCCTCG-1	TAGTTGGGTAGCCTCG
TATCAGGAGATCTGCT-1	TATCAGGAGATCTGCT
TATCTCACACGTCTCT-1	TATCTCACACGTCTCT
TATGCCCAGGGTGTTG-1	TATGCCCAGGGTGTTG
TATGCCCGTAATCGTC-1	TATGCCCGTAATCGTC
TATGCCCGTACCAGTT-1	TATGCCCGTACCAGTT
TATGCCCTCCCAGGTG-1	TATGCCCTCCCAGGTG
TATGCCCTCCCTCAGT-1	TATGCCCTCCCTCAGT
TATTACCCATCTATGG-1	TATTACCCATCTATGG
TATTACCGTAGCCTCG-1	TATTACCGTAGCCTCG
TCAACGATCCTAAGTG-1	TCAACGATCCTAAGTG
TCAACGATCTCGCTTG-1	TCAACGATCTCGCTTG
TCACAAGCATGGTCTA-1	TCACAAGCATGGTCTA
TCACAAGCATTTGCTT-1	TCACAAGCATTTGCTT
TCACAAGTCGTAGGTT-1	TCACAAGTCGTAGGTT
TCAGCAACACGAAACG-1	TCAGCAACACGAAACG
TCAGCAATCACCGGGT-1	TCAGCAATCACCGGGT
TCAGGATAGCTGTTCA-1	TCAGGATAGCTGTTCA
TCAGGTATCTAAGCCA-1	TCAGGTATCTAAGCCA
TCAGGTATCTTAGCCC-1	TCAGGTATCTTAGCCC
TCATTACGTTGTCTTT-1	TCATTACGTTGTCTTT
TCATTACTCTGCCAGG-1	TCATTACTCTGCCAGG
TCATTTGGTACTTCTT-1	TCATTTGGTACTTCTT
TCATTTGTCAGAGGTG-1	TCATTTGTCAGAGGTG
TCCACACCAGCGAACA-1	TCCACACCAGCGAACA
TCCACACGTGCACTTA-1	TCCACACGTGCACTTA
TCCCGATAGGCATTGG-1	TCCCGATAGGCATTGG
TCCCGATCATGTCTCC-1	TCCCGATCATGTCTCC
TCCCGATCATGTTGAC-1	TCCCGATCATGTTGAC
TCCCGATGTCATCGGC-1	TCCCGATGTCATCGGC
TCCCGATGTCGTGGCT-1	TCCCGATGTCGTGGCT
TCCCGATTCTTAGCCC-1	TCCCGATTCTTAGCCC
TCGAGGCAGAGTAAGG-1	TCGAGGCAGAGTAAGG
TCGAGGCCATTTGCTT-1	TCGAGGCCATTTGCTT
TCGAGGCTCGAATGGG-1	TCGAGGCTCGAATGGG
TCGCGAGCAAGAAGAG-1	TCGCGAGCAAGAAGAG
TCGCGAGGTAAACACA-1	TCGCGAGGTAAACACA
TCGCGAGGTTTCGCTC-1	TCGCGAGGTTTCGCTC
TCGCGTTAGATCGATA-1	TCGCGTTAGATCGATA
TCGCGTTTCGTTTAGG-1	TCGCGTTTCGTTTAGG
TCGGGACCAGACAGGT-1	TCGGGACCAGACAGGT
TCGGTAACAAGGTGTG-1	TCGGTAACAAGGTGTG
TCGGTAAGTAAGTAGT-1	TCGGTAAGTAAGTAGT
TCGTACCGTAGGCATG-1	TCGTACCGTAGGCATG
TCGTACCGTGATGTGG-1	TCGTACCGTGATGTGG
TCGTACCTCCGTTGTC-1	TCGTACCTCCGTTGTC
TCGTAGAGTGCCTGTG-1	TCGTAGAGTGCCTGTG
TCGTAGATCCGCAAGC-1	TCGTAGATCCGCAAGC
TCTATTGAGGCTAGGT-1	TCTATTGAGGCTAGGT
TCTATTGCAAGAGTCG-1	TCTATTGCAAGAGTCG
TCTATTGCACCGATAT-1	TCTATTGCACCGATAT
TCTATTGGTATATCCG-1	TCTATTGGTATATCCG
TCTATTGTCCCTAATT-1	TCTATTGTCCCTAATT
TCTCATAAGTTTGCGT-1	TCTCATAAGTTTGCGT
TCTCTAACATCTATGG-1	TCTCTAACATCTATGG
TCTCTAACATGCAACT-1	TCTCTAACATGCAACT
TCTGAGACAATGAAAC-1	TCTGAGACAATGAAAC
TCTGGAAAGAGCCTAG-1	TCTGGAAAGAGCCTAG
TCTGGAATCCTTGGTC-1	TCTGGAATCCTTGGTC
TCTTCGGTCAGCAACT-1	TCTTCGGTCAGCAACT
TCTTCGGTCTAACTCT-1	TCTTCGGTCTAACTCT
TCTTCGGTCTGTCTCG-1	TCTTCGGTCTGTCTCG
TGAAAGAAGTCGCCGT-1	TGAAAGAAGTCGCCGT
TGAAAGAGTCATACTG-1	TGAAAGAGTCATACTG
TGACTTTGTAGCGCTC-1	TGACTTTGTAGCGCTC
TGACTTTTCACCTCGT-1	TGACTTTTCACCTCGT
TGAGAGGGTCGTTGTA-1	TGAGAGGGTCGTTGTA
TGAGAGGGTTCGCGAC-1	TGAGAGGGTTCGCGAC
TGAGCATAGACCACGA-1	TGAGCATAGACCACGA
TGAGCATAGGCAGTCA-1	TGAGCATAGGCAGTCA
TGAGCATAGTTATCGC-1	TGAGCATAGTTATCGC
TGAGCATGTTCCACAA-1	TGAGCATGTTCCACAA
TGAGCATTCCAAACTG-1	TGAGCATTCCAAACTG
TGAGGGAGTGTCAATC-1	TGAGGGAGTGTCAATC
TGATTTCGTGCTTCTC-1	TGATTTCGTGCTTCTC
TGATTTCTCCGCGTTT-1	TGATTTCTCCGCGTTT
TGCCAAACAGGGCATA-1	TGCCAAACAGGGCATA
TGCCAAATCGGTCTAA-1	TGCCAAATCGGTCTAA
TGCCCATAGACTAGGC-1	TGCCCATAGACTAGGC
TGCCCATCAGTATAAG-1	TGCCCATCAGTATAAG
TGCCCATGTGGTCTCG-1	TGCCCATGTGGTCTCG
TGCCCTAAGGGAGTAA-1	TGCCCTAAGGGAGTAA
TGCCCTAGTAAGCACG-1	TGCCCTAGTAAGCACG
TGCCCTATCCAAGTAC-1	TGCCCTATCCAAGTAC
TGCGCAGCATTAACCG-1	TGCGCAGCATTAACCG
TGCGGGTAGATCACGG-1	TGCGGGTAGATCACGG
TGCGGGTCAATGTTGC-1	TGCGGGTCAATGTTGC
TGCGGGTCACAGACTT-1	TGCGGGTCACAGACTT
TGCGGGTCACCTGGTG-1	TGCGGGTCACCTGGTG
TGCGTGGAGCCAGTAG-1	TGCGTGGAGCCAGTAG
TGCGTGGTCGGTGTCG-1	TGCGTGGTCGGTGTCG
TGCGTGGTCTGCGGCA-1	TGCGTGGTCTGCGGCA
TGCTACCGTAGCGTGA-1	TGCTACCGTAGCGTGA
TGGACGCAGTGTACTC-1	TGGACGCAGTGTACTC
TGGCCAGAGCTTCGCG-1	TGGCCAGAGCTTCGCG
TGGCCAGTCTGATACG-1	TGGCCAGTCTGATACG
TGGCGCACATTCACTT-1	TGGCGCACATTCACTT
TGGCGCAGTCCGTCAG-1	TGGCGCAGTCCGTCAG
TGGCGCAGTCCTAGCG-1	TGGCGCAGTCCTAGCG
TGGGCGTGTAGAAAGG-1	TGGGCGTGTAGAAAGG
TGGGCGTGTGTGTGCC-1	TGGGCGTGTGTGTGCC
TGGTTAGCAGCTCGCA-1	TGGTTAGCAGCTCGCA
TGGTTAGCATATACCG-1	TGGTTAGCATATACCG
TGGTTCCAGCCTCGTG-1	TGGTTCCAGCCTCGTG
TGGTTCCCACGGCTAC-1	TGGTTCCCACGGCTAC
TGGTTCCGTTTGACAC-1	TGGTTCCGTTTGACAC
TGTATTCAGAATGTTG-1	TGTATTCAGAATGTTG
TGTATTCCACAGATTC-1	TGTATTCCACAGATTC
TGTATTCCAGACTCGC-1	TGTATTCCAGACTCGC
TGTATTCGTCCAGTAT-1	TGTATTCGTCCAGTAT
TGTATTCTCATGCAAC-1	TGTATTCTCATGCAAC
TGTGGTAAGATGTCGG-1	TGTGGTAAGATGTCGG
TGTGGTAAGGACAGAA-1	TGTGGTAAGGACAGAA
TGTGGTAAGTGTCCCG-1	TGTGGTAAGTGTCCCG
TGTGGTAGTTGCCTCT-1	TGTGGTAGTTGCCTCT
TGTTCCGAGCGGCTTC-1	TGTTCCGAGCGGCTTC
TGTTCCGAGTAGCCGA-1	TGTTCCGAGTAGCCGA
TGTTCCGGTGTTGGGA-1	TGTTCCGGTGTTGGGA
TGTTCCGTCATTGCCC-1	TGTTCCGTCATTGCCC
TTAACTCAGCATGGCA-1	TTAACTCAGCATGGCA
TTAACTCCATGTCCTC-1	TTAACTCCATGTCCTC
TTAGGACGTGTTTGGT-1	TTAGGACGTGTTTGGT
TTAGGACTCGTTACAG-1	TTAGGACTCGTTACAG
TTAGGCACATGTTGAC-1	TTAGGCACATGTTGAC
TTATGCTAGAAACCGC-1	TTATGCTAGAAACCGC
TTCCCAGGTCTAAACC-1	TTCCCAGGTCTAAACC
TTCCCAGGTTGGTGGA-1	TTCCCAGGTTGGTGGA
TTCCCAGTCTAACGGT-1	TTCCCAGTCTAACGGT
TTCGAAGCAGGAACGT-1	TTCGAAGCAGGAACGT
TTCGGTCCACTTAAGC-1	TTCGGTCCACTTAAGC
TTCTACAGTTATCACG-1	TTCTACAGTTATCACG
TTCTACAGTTGTCTTT-1	TTCTACAGTTGTCTTT
TTCTCCTGTGAGTGAC-1	TTCTCCTGTGAGTGAC
TTCTTAGCACGGTTTA-1	TTCTTAGCACGGTTTA
TTCTTAGGTACAGTTC-1	TTCTTAGGTACAGTTC
TTCTTAGTCTCTGCTG-1	TTCTTAGTCTCTGCTG
TTGACTTAGTGCGATG-1	TTGACTTAGTGCGATG
TTGACTTCAGACACTT-1	TTGACTTCAGACACTT
TTGACTTCAGCTCGCA-1	TTGACTTCAGCTCGCA
TTGCCGTAGAAGGGTA-1	TTGCCGTAGAAGGGTA
TTGCCGTCAGCTGGCT-1	TTGCCGTCAGCTGGCT
TTGCGTCAGCTGATAA-1	TTGCGTCAGCTGATAA
TTGGAACCAGACAGGT-1	TTGGAACCAGACAGGT
TTGGAACTCCGTCATC-1	TTGGAACTCCGTCATC
TTGGCAAGTAGAAGGA-1	TTGGCAAGTAGAAGGA
TTGTAGGAGACTGGGT-1	TTGTAGGAGACTGGGT
TTGTAGGAGCGAAGGG-1	TTGTAGGAGCGAAGGG
TTGTAGGAGTTGTCGT-1	TTGTAGGAGTTGTCGT
TTTACTGAGCCCTAAT-1	TTTACTGAGCCCTAAT
TTTACTGCACCATCCT-1	TTTACTGCACCATCCT
TTTACTGGTATTAGCC-1	TTTACTGGTATTAGCC
TTTACTGGTCAAGCGA-1	TTTACTGGTCAAGCGA
TTTATGCCAAATCCGT-1	TTTATGCCAAATCCGT
TTTATGCTCTGCGGCA-1	TTTATGCTCTGCGGCA
TTTCCTCTCAGCTGGC-1	TTTCCTCTCAGCTGGC
TTTGTCACAGGTCCAC-1	TTTGTCACAGGTCCAC
TTTGTCATCATACGGT-1	TTTGTCATCATACGGT
AAACCTGCATGGTCTA-1	AAACCTGCATGGTCTA
AAACGGGAGGCCCTTG-1	AAACGGGAGGCCCTTG
AAACGGGGTGCTTCTC-1	AAACGGGGTGCTTCTC
AAAGCAACACGGCGTT-1	AAAGCAACACGGCGTT
AAAGCAAGTGACAAAT-1	AAAGCAAGTGACAAAT
AAAGCAATCGGCGGTT-1	AAAGCAATCGGCGGTT
AAAGTAGGTATAGGGC-1	AAAGTAGGTATAGGGC
AAATGCCCAGCTATTG-1	AAATGCCCAGCTATTG
AAATGCCTCAGGCCCA-1	AAATGCCTCAGGCCCA
AAATGCCTCCAAACAC-1	AAATGCCTCCAAACAC
AACACGTAGTCCGTAT-1	AACACGTAGTCCGTAT
AACCGCGCAGGAATCG-1	AACCGCGCAGGAATCG
AACGTTGTCTCTAAGG-1	AACGTTGTCTCTAAGG
AACTCAGTCACTATTC-1	AACTCAGTCACTATTC
AACTCCCCACGGTGTC-1	AACTCCCCACGGTGTC
AACTCTTAGGGTGTTG-1	AACTCTTAGGGTGTTG
AACTGGTTCCCAAGTA-1	AACTGGTTCCCAAGTA
AAGACCTCACTGTGTA-1	AAGACCTCACTGTGTA
AAGCCGCCAGTAACGG-1	AAGCCGCCAGTAACGG
AAGGAGCCAATGAATG-1	AAGGAGCCAATGAATG
AAGGAGCGTTCCCGAG-1	AAGGAGCGTTCCCGAG
AAGGAGCTCCATGAGT-1	AAGGAGCTCCATGAGT
AAGGAGCTCTGGAGCC-1	AAGGAGCTCTGGAGCC
AAGGCAGAGGCCCGTT-1	AAGGCAGAGGCCCGTT
AAGTCTGCAGTTAACC-1	AAGTCTGCAGTTAACC
AAGTCTGGTAGGCTGA-1	AAGTCTGGTAGGCTGA
AATCCAGTCCTTGCCA-1	AATCCAGTCCTTGCCA
AATCGGTAGCGCCTTG-1	AATCGGTAGCGCCTTG
AATCGGTAGGACGAAA-1	AATCGGTAGGACGAAA
ACACCAAAGCAGCCTC-1	ACACCAAAGCAGCCTC
ACACCAAAGCGTTGCC-1	ACACCAAAGCGTTGCC
ACACCAAGTACAGTTC-1	ACACCAAGTACAGTTC
ACACCCTCAACTTGAC-1	ACACCCTCAACTTGAC
ACACCGGAGACCACGA-1	ACACCGGAGACCACGA
ACACCGGGTGAGTATA-1	ACACCGGGTGAGTATA
ACACTGAGTTGCCTCT-1	ACACTGAGTTGCCTCT
ACACTGATCCTCAATT-1	ACACTGATCCTCAATT
ACAGCCGCAAAGCAAT-1	ACAGCCGCAAAGCAAT
ACAGCCGCAACACCCG-1	ACAGCCGCAACACCCG
ACAGCCGGTGCAGGTA-1	ACAGCCGGTGCAGGTA
ACAGCTAAGAAAGTGG-1	ACAGCTAAGAAAGTGG
ACAGCTACAAGGACTG-1	ACAGCTACAAGGACTG
ACAGCTAGTCTTCAAG-1	ACAGCTAGTCTTCAAG
ACATACGCATGTTGAC-1	ACATACGCATGTTGAC
ACATCAGAGATCTGCT-1	ACATCAGAGATCTGCT
ACATCAGTCAACACTG-1	ACATCAGTCAACACTG
ACCAGTAAGCTACCGC-1	ACCAGTAAGCTACCGC
ACCAGTAAGGCTAGCA-1	ACCAGTAAGGCTAGCA
ACCCACTAGGTGACCA-1	ACCCACTAGGTGACCA
ACCGTAAAGCCGATTT-1	ACCGTAAAGCCGATTT
ACCGTAAAGTGTTGAA-1	ACCGTAAAGTGTTGAA
ACCGTAACAATGGTCT-1	ACCGTAACAATGGTCT
ACCGTAACACGGTAGA-1	ACCGTAACACGGTAGA
ACCGTAATCGTTGACA-1	ACCGTAATCGTTGACA
ACCTTTAAGGATATAC-1	ACCTTTAAGGATATAC
ACGAGGAAGTTAGCGG-1	ACGAGGAAGTTAGCGG
ACGAGGACATGGTCTA-1	ACGAGGACATGGTCTA
ACGATACTCAGCATGT-1	ACGATACTCAGCATGT
ACGATGTGTCTAAAGA-1	ACGATGTGTCTAAAGA
ACGCAGCTCAAAGTAG-1	ACGCAGCTCAAAGTAG
ACGCAGCTCCTCATTA-1	ACGCAGCTCCTCATTA
ACGCCAGAGTGATCGG-1	ACGCCAGAGTGATCGG
ACGCCAGGTTACTGAC-1	ACGCCAGGTTACTGAC
ACGCCAGTCTGGAGCC-1	ACGCCAGTCTGGAGCC
ACGGAGAAGGCATGTG-1	ACGGAGAAGGCATGTG
ACGGAGACATCATCCC-1	ACGGAGACATCATCCC
ACGGAGAGTACAGTGG-1	ACGGAGAGTACAGTGG
ACGGCCACAGCCTTTC-1	ACGGCCACAGCCTTTC
ACGGCCACAGGAATCG-1	ACGGCCACAGGAATCG
ACGGCCACATCTCCCA-1	ACGGCCACATCTCCCA
ACGGCCATCTCGAGTA-1	ACGGCCATCTCGAGTA
ACGGGCTAGCTGCGAA-1	ACGGGCTAGCTGCGAA
ACGGGCTAGTACATGA-1	ACGGGCTAGTACATGA
ACGGGCTCATCATCCC-1	ACGGGCTCATCATCCC
ACGGGTCGTGTTCGAT-1	ACGGGTCGTGTTCGAT
ACGTCAAAGACCTTTG-1	ACGTCAAAGACCTTTG
ACGTCAACAAACGCGA-1	ACGTCAACAAACGCGA
ACGTCAATCTCTTGAT-1	ACGTCAATCTCTTGAT
ACTGAACAGTGCCATT-1	ACTGAACAGTGCCATT
ACTGAGTGTACCGTTA-1	ACTGAGTGTACCGTTA
ACTGAGTGTTAGAACA-1	ACTGAGTGTTAGAACA
ACTGATGAGAGTACAT-1	ACTGATGAGAGTACAT
ACTGATGTCGCTTGTC-1	ACTGATGTCGCTTGTC
ACTGCTCCATCAGTAC-1	ACTGCTCCATCAGTAC
ACTTACTCACAGGCCT-1	ACTTACTCACAGGCCT
ACTTACTGTTACGCGC-1	ACTTACTGTTACGCGC
ACTTGTTCATGCTAGT-1	ACTTGTTCATGCTAGT
ACTTGTTGTGCTAGCC-1	ACTTGTTGTGCTAGCC
AGACGTTTCACAAACC-1	AGACGTTTCACAAACC
AGAGCGACAGCATACT-1	AGAGCGACAGCATACT
AGAGCGACAGTCCTTC-1	AGAGCGACAGTCCTTC
AGAGCGATCAAGATCC-1	AGAGCGATCAAGATCC
AGAGCTTAGCTACCGC-1	AGAGCTTAGCTACCGC
AGAGCTTTCACTCCTG-1	AGAGCTTTCACTCCTG
AGAGTGGAGAGATGAG-1	AGAGTGGAGAGATGAG
AGAGTGGTCCTAAGTG-1	AGAGTGGTCCTAAGTG
AGAGTGGTCCTATGTT-1	AGAGTGGTCCTATGTT
AGAGTGGTCTATCCTA-1	AGAGTGGTCTATCCTA
AGATTGCCAAGAAAGG-1	AGATTGCCAAGAAAGG
AGATTGCCACAGGCCT-1	AGATTGCCACAGGCCT
AGATTGCCACCTGGTG-1	AGATTGCCACCTGGTG
AGCAGCCAGACAATAC-1	AGCAGCCAGACAATAC
AGCAGCCCACCAGGTC-1	AGCAGCCCACCAGGTC
AGCAGCCCAGGGTTAG-1	AGCAGCCCAGGGTTAG
AGCAGCCTCCAAACTG-1	AGCAGCCTCCAAACTG
AGCAGCCTCCAGAGGA-1	AGCAGCCTCCAGAGGA
AGCATACCAGATCTGT-1	AGCATACCAGATCTGT
AGCCTAACATGAACCT-1	AGCCTAACATGAACCT
AGCCTAACATGTCCTC-1	AGCCTAACATGTCCTC
AGCCTAAGTCAAACTC-1	AGCCTAAGTCAAACTC
AGCGGTCAGGATGGTC-1	AGCGGTCAGGATGGTC
AGCGTATTCGAGGTAG-1	AGCGTATTCGAGGTAG
AGCGTCGTCTTCCTTC-1	AGCGTCGTCTTCCTTC
AGCTCCTAGAAGGGTA-1	AGCTCCTAGAAGGGTA
AGCTCTCAGCTTTGGT-1	AGCTCTCAGCTTTGGT
AGCTCTCAGTGTTGAA-1	AGCTCTCAGTGTTGAA
AGGCCACAGTCTCGGC-1	AGGCCACAGTCTCGGC
AGGCCGTTCCGAATGT-1	AGGCCGTTCCGAATGT
AGGCCGTTCTGCCCTA-1	AGGCCGTTCTGCCCTA
AGGGAGTCAGACTCGC-1	AGGGAGTCAGACTCGC
AGGGAGTTCTTGCCGT-1	AGGGAGTTCTTGCCGT
AGGGATGCAAACCCAT-1	AGGGATGCAAACCCAT
AGGTCATAGAGGACGG-1	AGGTCATAGAGGACGG
AGGTCATTCTTAGCCC-1	AGGTCATTCTTAGCCC
AGTAGTCAGTAGTGCG-1	AGTAGTCAGTAGTGCG
AGTAGTCAGTCCGTAT-1	AGTAGTCAGTCCGTAT
AGTAGTCTCCACGCAG-1	AGTAGTCTCCACGCAG
AGTCTTTAGGCTAGGT-1	AGTCTTTAGGCTAGGT
AGTCTTTTCTACTTAC-1	AGTCTTTTCTACTTAC
AGTCTTTTCTCTGTCG-1	AGTCTTTTCTCTGTCG
AGTGAGGAGACCTTTG-1	AGTGAGGAGACCTTTG
AGTGAGGCATTAACCG-1	AGTGAGGCATTAACCG
AGTGAGGGTCAATACC-1	AGTGAGGGTCAATACC
AGTGAGGTCATCGGAT-1	AGTGAGGTCATCGGAT
AGTGGGACATGTAGTC-1	AGTGGGACATGTAGTC
AGTGGGATCAACGAAA-1	AGTGGGATCAACGAAA
AGTGTCATCATGGTCA-1	AGTGTCATCATGGTCA
ATAACGCGTCACTGGC-1	ATAACGCGTCACTGGC
ATAGACCTCATGCAAC-1	ATAGACCTCATGCAAC
ATCACGAAGTAGGCCA-1	ATCACGAAGTAGGCCA
ATCACGACACCAGGTC-1	ATCACGACACCAGGTC
ATCACGAGTGACTACT-1	ATCACGAGTGACTACT
ATCATCTCATCGATTG-1	ATCATCTCATCGATTG
ATCATCTCATGAAGTA-1	ATCATCTCATGAAGTA
ATCATCTGTTAAAGTG-1	ATCATCTGTTAAAGTG
ATCATGGAGCAACGGT-1	ATCATGGAGCAACGGT
ATCATGGCAATGAAAC-1	ATCATGGCAATGAAAC
ATCATGGGTAAGAGAG-1	ATCATGGGTAAGAGAG
ATCATGGTCAACACTG-1	ATCATGGTCAACACTG
ATCGAGTAGTGTTTGC-1	ATCGAGTAGTGTTTGC
ATCGAGTCATCGTCGG-1	ATCGAGTCATCGTCGG
ATCTGCCCACGAAGCA-1	ATCTGCCCACGAAGCA
ATCTGCCCAGCTGTAT-1	ATCTGCCCAGCTGTAT
ATCTGCCCATTCCTCG-1	ATCTGCCCATTCCTCG
ATCTGCCTCGCGATCG-1	ATCTGCCTCGCGATCG
ATCTGCCTCTCCAACC-1	ATCTGCCTCTCCAACC
ATGAGGGAGCTGAAAT-1	ATGAGGGAGCTGAAAT
ATGAGGGGTGAGTGAC-1	ATGAGGGGTGAGTGAC
ATGGGAGCACACTGCG-1	ATGGGAGCACACTGCG
ATGGGAGCATGACGGA-1	ATGGGAGCATGACGGA
ATGGGAGGTAGTACCT-1	ATGGGAGGTAGTACCT
ATGGGAGGTCCCTTGT-1	ATGGGAGGTCCCTTGT
ATGTGTGTCACAACGT-1	ATGTGTGTCACAACGT
ATTACTCCAGCGATCC-1	ATTACTCCAGCGATCC
ATTACTCGTTCCAACA-1	ATTACTCGTTCCAACA
ATTATCCAGCACCGTC-1	ATTATCCAGCACCGTC
ATTATCCGTTCGTGAT-1	ATTATCCGTTCGTGAT
ATTGGACAGGAGTACC-1	ATTGGACAGGAGTACC
ATTGGACAGTGGGCTA-1	ATTGGACAGTGGGCTA
ATTGGACGTAGATTAG-1	ATTGGACGTAGATTAG
ATTGGACTCACAACGT-1	ATTGGACTCACAACGT
ATTGGTGCATCGGACC-1	ATTGGTGCATCGGACC
ATTGGTGTCAGTCCCT-1	ATTGGTGTCAGTCCCT
ATTTCTGAGCCTTGAT-1	ATTTCTGAGCCTTGAT
ATTTCTGAGTCGAGTG-1	ATTTCTGAGTCGAGTG
ATTTCTGGTATATGGA-1	ATTTCTGGTATATGGA
ATTTCTGGTCGGATCC-1	ATTTCTGGTCGGATCC
CAACCAATCAAGGTAA-1	CAACCAATCAAGGTAA
CAACCTCAGGATTCGG-1	CAACCTCAGGATTCGG
CAACCTCAGGCATGGT-1	CAACCTCAGGCATGGT
CAACCTCGTGCAGGTA-1	CAACCTCGTGCAGGTA
CAACTAGCAAGCGATG-1	CAACTAGCAAGCGATG
CAACTAGGTACATGTC-1	CAACTAGGTACATGTC
CAAGAAAGTGTATGGG-1	CAAGAAAGTGTATGGG
CAAGAAATCCGAACGC-1	CAAGAAATCCGAACGC
CAAGATCGTACTCGCG-1	CAAGATCGTACTCGCG
CAAGATCGTCTAGTCA-1	CAAGATCGTCTAGTCA
CAAGGCCCACGGTAAG-1	CAAGGCCCACGGTAAG
CACAAACGTAGGGTAC-1	CACAAACGTAGGGTAC
CACAAACGTGTGTGCC-1	CACAAACGTGTGTGCC
CACAAACTCACCCGAG-1	CACAAACTCACCCGAG
CACACAAGTGCTGTAT-1	CACACAAGTGCTGTAT
CACACCTCATTGGGCC-1	CACACCTCATTGGGCC
CACACCTTCCCACTTG-1	CACACCTTCCCACTTG
CACAGGCTCGTCTGCT-1	CACAGGCTCGTCTGCT
CACAGGCTCTGTCTCG-1	CACAGGCTCTGTCTCG
CACAGTAGTAGCTGCC-1	CACAGTAGTAGCTGCC
CACATAGCATTGAGCT-1	CACATAGCATTGAGCT
CACATTTCATACGCCG-1	CACATTTCATACGCCG
CACATTTGTCTTTCAT-1	CACATTTGTCTTTCAT
CACATTTGTGTAAGTA-1	CACATTTGTGTAAGTA
CACATTTTCCAAACTG-1	CACATTTTCCAAACTG
CACCACTAGAAACCGC-1	CACCACTAGAAACCGC
CACCACTAGCTAGTGG-1	CACCACTAGCTAGTGG
CACCACTGTACCGTAT-1	CACCACTGTACCGTAT
CACCAGGAGAAACGAG-1	CACCAGGAGAAACGAG
CACCAGGAGGTCGGAT-1	CACCAGGAGGTCGGAT
CACCAGGTCACTTACT-1	CACCAGGTCACTTACT
CACCAGGTCTACTCAT-1	CACCAGGTCTACTCAT
CACCTTGCATGTCCTC-1	CACCTTGCATGTCCTC
CACTCCAAGCACCGCT-1	CACTCCAAGCACCGCT
CACTCCAAGTAGGTGC-1	CACTCCAAGTAGGTGC
CACTCCAAGTGCGTGA-1	CACTCCAAGTGCGTGA
CAGAATCAGCTCAACT-1	CAGAATCAGCTCAACT
CAGAGAGGTCAAAGCG-1	CAGAGAGGTCAAAGCG
CAGATCACACCTATCC-1	CAGATCACACCTATCC
CAGATCACATGACGGA-1	CAGATCACATGACGGA
CAGCAGCCAGCTGTTA-1	CAGCAGCCAGCTGTTA
CAGCAGCGTACAGTTC-1	CAGCAGCGTACAGTTC
CAGCCGAAGAGTTGGC-1	CAGCCGAAGAGTTGGC
CAGGTGCAGATATACG-1	CAGGTGCAGATATACG
CAGGTGCAGTACGCGA-1	CAGGTGCAGTACGCGA
CAGTAACAGTTGAGTA-1	CAGTAACAGTTGAGTA
CAGTAACGTTTGCATG-1	CAGTAACGTTTGCATG
CAGTCCTGTTCCGTCT-1	CAGTCCTGTTCCGTCT
CATATGGCAGACGCCT-1	CATATGGCAGACGCCT
CATATGGGTAGCTTGT-1	CATATGGGTAGCTTGT
CATATGGGTTTGTGTG-1	CATATGGGTTTGTGTG
CATATGGTCGGCATCG-1	CATATGGTCGGCATCG
CATCAAGGTCGGCTCA-1	CATCAAGGTCGGCTCA
CATCAAGGTTCATGGT-1	CATCAAGGTTCATGGT
CATCAGAAGTGGGTTG-1	CATCAGAAGTGGGTTG
CATCGGGTCGGCATCG-1	CATCGGGTCGGCATCG
CATCGGGTCTTGCAAG-1	CATCGGGTCTTGCAAG
CATCGGGTCTTTCCTC-1	CATCGGGTCTTTCCTC
CATGCCTCAAACGTGG-1	CATGCCTCAAACGTGG
CATGCCTGTAGTACCT-1	CATGCCTGTAGTACCT
CATGCCTGTATCAGTC-1	CATGCCTGTATCAGTC
CATTCGCGTCAACTGT-1	CATTCGCGTCAACTGT
CCACCTAGTAACGACG-1	CCACCTAGTAACGACG
CCACGGAAGATGTCGG-1	CCACGGAAGATGTCGG
CCACGGAAGGCTATCT-1	CCACGGAAGGCTATCT
CCACGGATCATTCACT-1	CCACGGATCATTCACT
CCACTACCAAGGCTCC-1	CCACTACCAAGGCTCC
CCACTACGTCTAAAGA-1	CCACTACGTCTAAAGA
CCATGTCCAGATGAGC-1	CCATGTCCAGATGAGC
CCATGTCCAGCATACT-1	CCATGTCCAGCATACT
CCATGTCCAGTAAGAT-1	CCATGTCCAGTAAGAT
CCATTCGTCTAGAGTC-1	CCATTCGTCTAGAGTC
CCCAATCGTTGTGGAG-1	CCCAATCGTTGTGGAG
CCCAGTTAGGCTAGGT-1	CCCAGTTAGGCTAGGT
CCCATACAGCACGCCT-1	CCCATACAGCACGCCT
CCCATACAGTGAAGAG-1	CCCATACAGTGAAGAG
CCCTCCTTCGTGGTCG-1	CCCTCCTTCGTGGTCG
CCGGGATAGAGCTTCT-1	CCGGGATAGAGCTTCT
CCGTACTTCCAGTATG-1	CCGTACTTCCAGTATG
CCGTGGAAGTTCCACA-1	CCGTGGAAGTTCCACA
CCGTGGATCCTTGGTC-1	CCGTGGATCCTTGGTC
CCGTTCATCTATCGCC-1	CCGTTCATCTATCGCC
CCTACACGTGTGGTTT-1	CCTACACGTGTGGTTT
CCTACACTCCAAGCCG-1	CCTACACTCCAAGCCG
CCTACCACAACGCACC-1	CCTACCACAACGCACC
CCTACCACATCGATTG-1	CCTACCACATCGATTG
CCTAGCTGTCTCTCTG-1	CCTAGCTGTCTCTCTG
CCTCAGTCAAGTCATC-1	CCTCAGTCAAGTCATC
CCTCAGTTCATGTCTT-1	CCTCAGTTCATGTCTT
CCTCAGTTCCGTTGCT-1	CCTCAGTTCCGTTGCT
CCTCTGACACCAACCG-1	CCTCTGACACCAACCG
CCTTACGGTGTAACGG-1	CCTTACGGTGTAACGG
CCTTACGTCAATCACG-1	CCTTACGTCAATCACG
CCTTACGTCAGGTTCA-1	CCTTACGTCAGGTTCA
CCTTACGTCTGCGACG-1	CCTTACGTCTGCGACG
CGACCTTCATATACCG-1	CGACCTTCATATACCG
CGACCTTGTCACTGGC-1	CGACCTTGTCACTGGC
CGACTTCGTTTGGGCC-1	CGACTTCGTTTGGGCC
CGAGAAGCATTCTTAC-1	CGAGAAGCATTCTTAC
CGAGCACAGACCTAGG-1	CGAGCACAGACCTAGG
CGAGCACCAAGAGGCT-1	CGAGCACCAAGAGGCT
CGAGCACCACAGCCCA-1	CGAGCACCACAGCCCA
CGAGCACGTGGGTATG-1	CGAGCACGTGGGTATG
CGAGCCAAGATATGGT-1	CGAGCCAAGATATGGT
CGAGCCAAGGCCATAG-1	CGAGCCAAGGCCATAG
CGAGCCACAAGTAGTA-1	CGAGCCACAAGTAGTA
CGATCGGGTTTGGCGC-1	CGATCGGGTTTGGCGC
CGATCGGTCACTATTC-1	CGATCGGTCACTATTC
CGATGGCAGAAGGCCT-1	CGATGGCAGAAGGCCT
CGATTGACACGTTGGC-1	CGATTGACACGTTGGC
CGATTGATCCTTTACA-1	CGATTGATCCTTTACA
CGCCAAGCACAGATTC-1	CGCCAAGCACAGATTC
CGCCAAGCATGTTGAC-1	CGCCAAGCATGTTGAC
CGCCAAGTCAAGATCC-1	CGCCAAGTCAAGATCC
CGCCAAGTCTACTATC-1	CGCCAAGTCTACTATC
CGCGGTACACACTGCG-1	CGCGGTACACACTGCG
CGCGTTTGTACGACCC-1	CGCGTTTGTACGACCC
CGCGTTTTCAACGGCC-1	CGCGTTTTCAACGGCC
CGCGTTTTCATGCTCC-1	CGCGTTTTCATGCTCC
CGCTATCAGGGCTTCC-1	CGCTATCAGGGCTTCC
CGCTATCCAAGGCTCC-1	CGCTATCCAAGGCTCC
CGCTGGAAGCTCCTCT-1	CGCTGGAAGCTCCTCT
CGCTTCAGTGTAACGG-1	CGCTTCAGTGTAACGG
CGGACGTCATGCGCAC-1	CGGACGTCATGCGCAC
CGGACTGTCCCTCTTT-1	CGGACTGTCCCTCTTT
CGGAGCTCACACCGAC-1	CGGAGCTCACACCGAC
CGGAGCTTCCAGTATG-1	CGGAGCTTCCAGTATG
CGGCTAGAGCTACCTA-1	CGGCTAGAGCTACCTA
CGGCTAGTCTCGGACG-1	CGGCTAGTCTCGGACG
CGTAGCGCATGAGCGA-1	CGTAGCGCATGAGCGA
CGTAGCGCATGCCTTC-1	CGTAGCGCATGCCTTC
CGTCACTCAGTGAGTG-1	CGTCACTCAGTGAGTG
CGTCAGGTCAAACGGG-1	CGTCAGGTCAAACGGG
CGTCCATCACACCGCA-1	CGTCCATCACACCGCA
CGTCTACCAGGATTGG-1	CGTCTACCAGGATTGG
CGTGAGCCAACTTGAC-1	CGTGAGCCAACTTGAC
CGTGAGCGTTACTGAC-1	CGTGAGCGTTACTGAC
CGTGTAAGTGTTTGGT-1	CGTGTAAGTGTTTGGT
CGTTGGGCACGTGAGA-1	CGTTGGGCACGTGAGA
CTAACTTAGATCTGCT-1	CTAACTTAGATCTGCT
CTAAGACGTCCGAGTC-1	CTAAGACGTCCGAGTC
CTAATGGAGGGTCTCC-1	CTAATGGAGGGTCTCC
CTAATGGAGGTAAACT-1	CTAATGGAGGTAAACT
CTACACCGTATGAATG-1	CTACACCGTATGAATG
CTACCCATCCTCATTA-1	CTACCCATCCTCATTA
CTACCCATCGGCCGAT-1	CTACCCATCGGCCGAT
CTAGAGTGTCGGCTCA-1	CTAGAGTGTCGGCTCA
CTAGAGTGTGTTCGAT-1	CTAGAGTGTGTTCGAT
CTAGCCTGTACGCACC-1	CTAGCCTGTACGCACC
CTAGTGAGTCGCGTGT-1	CTAGTGAGTCGCGTGT
CTCAGAACAAGGGTCA-1	CTCAGAACAAGGGTCA
CTCAGAACAGATCTGT-1	CTCAGAACAGATCTGT
CTCAGAATCGTCGTTC-1	CTCAGAATCGTCGTTC
CTCATTAAGTAATCCC-1	CTCATTAAGTAATCCC
CTCCTAGCAGGTGGAT-1	CTCCTAGCAGGTGGAT
CTCCTAGTCCGTTGCT-1	CTCCTAGTCCGTTGCT
CTCGGGACACGGTAGA-1	CTCGGGACACGGTAGA
CTCGTCAAGCTAGTGG-1	CTCGTCAAGCTAGTGG
CTCGTCATCGCCGTGA-1	CTCGTCATCGCCGTGA
CTCTACGCAAGGTTTC-1	CTCTACGCAAGGTTTC
CTCTGGTAGCGATAGC-1	CTCTGGTAGCGATAGC
CTGAAACAGGGTGTTG-1	CTGAAACAGGGTGTTG
CTGAAGTCAAGACGTG-1	CTGAAGTCAAGACGTG
CTGATAGTCACCTCGT-1	CTGATAGTCACCTCGT
CTGATCCCATGACGGA-1	CTGATCCCATGACGGA
CTGCGGAAGCCCAATT-1	CTGCGGAAGCCCAATT
CTGCTGTCACCTCGTT-1	CTGCTGTCACCTCGTT
CTGCTGTCAGAGTGTG-1	CTGCTGTCAGAGTGTG
CTGGTCTAGGCTCAGA-1	CTGGTCTAGGCTCAGA
CTGGTCTGTAGAAGGA-1	CTGGTCTGTAGAAGGA
CTGTGCTTCAAGCCTA-1	CTGTGCTTCAAGCCTA
CTGTGCTTCGGACAAG-1	CTGTGCTTCGGACAAG
CTTGGCTAGTACTTGC-1	CTTGGCTAGTACTTGC
CTTGGCTTCTCCAGGG-1	CTTGGCTTCTCCAGGG
GAAATGACACATTTCT-1	GAAATGACACATTTCT
GAAATGAGTCTTGATG-1	GAAATGAGTCTTGATG
GAACATCGTACAAGTA-1	GAACATCGTACAAGTA
GAACCTACATCCAACA-1	GAACCTACATCCAACA
GAACGGAGTAAGCACG-1	GAACGGAGTAAGCACG
GAACGGAGTTCCGGCA-1	GAACGGAGTTCCGGCA
GAATGAATCCAAGTAC-1	GAATGAATCCAAGTAC
GACACGCTCACCATAG-1	GACACGCTCACCATAG
GACACGCTCGTGGGAA-1	GACACGCTCGTGGGAA
GACAGAGAGCTGAAAT-1	GACAGAGAGCTGAAAT
GACGTTACAGACTCGC-1	GACGTTACAGACTCGC
GACTAACGTCTGATTG-1	GACTAACGTCTGATTG
GACTAACTCGATCCCT-1	GACTAACTCGATCCCT
GACTACACATGAACCT-1	GACTACACATGAACCT
GAGCAGATCTTGCATT-1	GAGCAGATCTTGCATT
GAGGTGAAGATGCCAG-1	GAGGTGAAGATGCCAG
GAGTCCGCATACGCCG-1	GAGTCCGCATACGCCG
GATCAGTAGTGGAGTC-1	GATCAGTAGTGGAGTC
GATCGATAGTGTCTCA-1	GATCGATAGTGTCTCA
GATCGCGGTCCGAACC-1	GATCGCGGTCCGAACC
GATCGCGGTCTCTCGT-1	GATCGCGGTCTCTCGT
GATCGCGTCCTTGACC-1	GATCGCGTCCTTGACC
GATGAGGCAGGATTGG-1	GATGAGGCAGGATTGG
GATGAGGCAGGTGCCT-1	GATGAGGCAGGTGCCT
GATTCAGCAGTCAGAG-1	GATTCAGCAGTCAGAG
GATTCAGTCCAAATGC-1	GATTCAGTCCAAATGC
GCAAACTAGGCTCTTA-1	GCAAACTAGGCTCTTA
GCAAACTGTGGTGTAG-1	GCAAACTGTGGTGTAG
GCACTCTAGTGTGGCA-1	GCACTCTAGTGTGGCA
GCACTCTCAGGCTGAA-1	GCACTCTCAGGCTGAA
GCACTCTGTTACGGAG-1	GCACTCTGTTACGGAG
GCACTCTTCATCGGAT-1	GCACTCTTCATCGGAT
GCACTCTTCGCGTTTC-1	GCACTCTTCGCGTTTC
GCACTCTTCTAACTCT-1	GCACTCTTCTAACTCT
GCAGTTATCCAGATCA-1	GCAGTTATCCAGATCA
GCATACACAGGTTTCA-1	GCATACACAGGTTTCA
GCATGATCATAGAAAC-1	GCATGATCATAGAAAC
GCATGATCATTCTTAC-1	GCATGATCATTCTTAC
GCATGATGTACATCCA-1	GCATGATGTACATCCA
GCATGATTCCACGTTC-1	GCATGATTCCACGTTC
GCATGATTCGTCTGCT-1	GCATGATTCGTCTGCT
GCATGTAAGAGTTGGC-1	GCATGTAAGAGTTGGC
GCATGTAGTAGAAGGA-1	GCATGTAGTAGAAGGA
GCCAAATCAATAGCGG-1	GCCAAATCAATAGCGG
GCCTCTAGTTACCGAT-1	GCCTCTAGTTACCGAT
GCCTCTATCGTGGTCG-1	GCCTCTATCGTGGTCG
GCCTCTATCTGGAGCC-1	GCCTCTATCTGGAGCC
GCGACCACAACTGGCC-1	GCGACCACAACTGGCC
GCGACCACAGACACTT-1	GCGACCACAGACACTT
GCGCAACAGAAGGACA-1	GCGCAACAGAAGGACA
GCGCAGTGTGGGTCAA-1	GCGCAGTGTGGGTCAA
GCGCAGTGTTTAGCTG-1	GCGCAGTGTTTAGCTG
GCGCGATAGAGTCTGG-1	GCGCGATAGAGTCTGG
GCGGGTTAGTGGGTTG-1	GCGGGTTAGTGGGTTG
GCTGCGAAGTCATGCT-1	GCTGCGAAGTCATGCT
GCTGCGAGTCATCGGC-1	GCTGCGAGTCATCGGC
GCTGCTTCAGATCCAT-1	GCTGCTTCAGATCCAT
GCTGCTTGTAGAGGAA-1	GCTGCTTGTAGAGGAA
GCTTCCACATTCTTAC-1	GCTTCCACATTCTTAC
GCTTCCAGTGATAAGT-1	GCTTCCAGTGATAAGT
GCTTCCAGTTTAGCTG-1	GCTTCCAGTTTAGCTG
GCTTCCATCCGTCAAA-1	GCTTCCATCCGTCAAA
GCTTGAAAGACTTTCG-1	GCTTGAAAGACTTTCG
GCTTGAATCTGCAGTA-1	GCTTGAATCTGCAGTA
GGAAAGCGTAAATACG-1	GGAAAGCGTAAATACG
GGAAAGCGTGGGTATG-1	GGAAAGCGTGGGTATG
GGAACTTCATCCCACT-1	GGAACTTCATCCCACT
GGAACTTGTGAAAGAG-1	GGAACTTGTGAAAGAG
GGAATAAGTAGCGCTC-1	GGAATAAGTAGCGCTC
GGACAAGCACGTTGGC-1	GGACAAGCACGTTGGC
GGACAGAAGACACTAA-1	GGACAGAAGACACTAA
GGACAGAGTCGGATCC-1	GGACAGAGTCGGATCC
GGACAGAGTTGCGTTA-1	GGACAGAGTTGCGTTA
GGACATTAGATGTCGG-1	GGACATTAGATGTCGG
GGACATTAGCCTCGTG-1	GGACATTAGCCTCGTG
GGACATTTCGCGCCAA-1	GGACATTTCGCGCCAA
GGACGTCGTGCTCTTC-1	GGACGTCGTGCTCTTC
GGACGTCTCGAACGGA-1	GGACGTCTCGAACGGA
GGAGCAAAGAATAGGG-1	GGAGCAAAGAATAGGG
GGATGTTAGGATGCGT-1	GGATGTTAGGATGCGT
GGATTACAGTTTGCGT-1	GGATTACAGTTTGCGT
GGCAATTAGTAGCGGT-1	GGCAATTAGTAGCGGT
GGCCGATCAATGCCAT-1	GGCCGATCAATGCCAT
GGCGACTAGAGTCGGT-1	GGCGACTAGAGTCGGT
GGGAATGAGAAACGAG-1	GGGAATGAGAAACGAG
GGGAATGGTCGAAAGC-1	GGGAATGGTCGAAAGC
GGGAGATTCCCATTTA-1	GGGAGATTCCCATTTA
GGGAGATTCTACGAGT-1	GGGAGATTCTACGAGT
GGGATGATCACAAACC-1	GGGATGATCACAAACC
GGGCATCGTCTAGTGT-1	GGGCATCGTCTAGTGT
GGGCATCGTGTGTGCC-1	GGGCATCGTGTGTGCC
GGGTCTGGTAAGAGGA-1	GGGTCTGGTAAGAGGA
GGGTTGCCAAGCCTAT-1	GGGTTGCCAAGCCTAT
GGGTTGCGTAGAAGGA-1	GGGTTGCGTAGAAGGA
GGGTTGCTCCGAATGT-1	GGGTTGCTCCGAATGT
GGTATTGGTTGTGGAG-1	GGTATTGGTTGTGGAG
GGTGAAGAGATGCCTT-1	GGTGAAGAGATGCCTT
GGTGAAGAGGAGTAGA-1	GGTGAAGAGGAGTAGA
GGTGAAGGTTCATGGT-1	GGTGAAGGTTCATGGT
GGTGCGTCAAGCTGTT-1	GGTGCGTCAAGCTGTT
GGTGCGTTCGTACCGG-1	GGTGCGTTCGTACCGG
GGTGTTAAGCGAAGGG-1	GGTGTTAAGCGAAGGG
GTAACGTTCGCCTGTT-1	GTAACGTTCGCCTGTT
GTAACTGCAGCGTCCA-1	GTAACTGCAGCGTCCA
GTAACTGTCCAAGTAC-1	GTAACTGTCCAAGTAC
GTACGTAAGACACGAC-1	GTACGTAAGACACGAC
GTACGTAAGTCCGTAT-1	GTACGTAAGTCCGTAT
GTACTCCGTAGGAGTC-1	GTACTCCGTAGGAGTC
GTACTCCTCAACTCTT-1	GTACTCCTCAACTCTT
GTACTTTGTCTAGAGG-1	GTACTTTGTCTAGAGG
GTACTTTGTGATGATA-1	GTACTTTGTGATGATA
GTAGGCCCATACCATG-1	GTAGGCCCATACCATG
GTAGGCCTCTTCCTTC-1	GTAGGCCTCTTCCTTC
GTAGTCAGTTCTGAAC-1	GTAGTCAGTTCTGAAC
GTATCTTGTACTCGCG-1	GTATCTTGTACTCGCG
GTATCTTTCTGTGCAA-1	GTATCTTTCTGTGCAA
GTATTCTAGAAGATTC-1	GTATTCTAGAAGATTC
GTCAAGTCATTCGACA-1	GTCAAGTCATTCGACA
GTCAAGTGTACAAGTA-1	GTCAAGTGTACAAGTA
GTCACAACAAACGTGG-1	GTCACAACAAACGTGG
GTCACAACAATGGAAT-1	GTCACAACAATGGAAT
GTCACGGCAAAGGTGC-1	GTCACGGCAAAGGTGC
GTCACGGGTATAAACG-1	GTCACGGGTATAAACG
GTCATTTAGACACGAC-1	GTCATTTAGACACGAC
GTCATTTAGAGCCTAG-1	GTCATTTAGAGCCTAG
GTCCTCACAGTATAAG-1	GTCCTCACAGTATAAG
GTCCTCATCTTAGCCC-1	GTCCTCATCTTAGCCC
GTCGGGTAGAGACGAA-1	GTCGGGTAGAGACGAA
GTCGTAATCTCGTTTA-1	GTCGTAATCTCGTTTA
GTCTCGTTCGTTGCCT-1	GTCTCGTTCGTTGCCT
GTCTTCGAGCAGCCTC-1	GTCTTCGAGCAGCCTC
GTGCATACAACTTGAC-1	GTGCATACAACTTGAC
GTGCATACATAGTAAG-1	GTGCATACATAGTAAG
GTGCATAGTTGCGCAC-1	GTGCATAGTTGCGCAC
GTGCGGTAGAGACGAA-1	GTGCGGTAGAGACGAA
GTGCGGTGTGTGAAAT-1	GTGCGGTGTGTGAAAT
GTGCGGTTCGCGGATC-1	GTGCGGTTCGCGGATC
GTGCGGTTCTCAAGTG-1	GTGCGGTTCTCAAGTG
GTGCTTCAGCGAGAAA-1	GTGCTTCAGCGAGAAA
GTGGGTCAGGCGTACA-1	GTGGGTCAGGCGTACA
GTGGGTCGTAAGTGGC-1	GTGGGTCGTAAGTGGC
GTGTGCGGTATTACCG-1	GTGTGCGGTATTACCG
GTGTTAGCAGACAAAT-1	GTGTTAGCAGACAAAT
GTGTTAGGTCATCGGC-1	GTGTTAGGTCATCGGC
GTGTTAGTCAGCGATT-1	GTGTTAGTCAGCGATT
GTGTTAGTCGAACGGA-1	GTGTTAGTCGAACGGA
GTTACAGCACTATCTT-1	GTTACAGCACTATCTT
GTTACAGCAGTAACGG-1	GTTACAGCAGTAACGG
GTTACAGTCATGCATG-1	GTTACAGTCATGCATG
GTTACAGTCTCTTGAT-1	GTTACAGTCTCTTGAT
GTTCATTCAAAGGCGT-1	GTTCATTCAAAGGCGT
GTTCATTCACTTCTGC-1	GTTCATTCACTTCTGC
GTTCATTGTGACGCCT-1	GTTCATTGTGACGCCT
GTTCGGGAGGGAGTAA-1	GTTCGGGAGGGAGTAA
GTTCTCGGTAGCACGA-1	GTTCTCGGTAGCACGA
GTTCTCGGTGCCTTGG-1	GTTCTCGGTGCCTTGG
GTTTCTAAGGCGTACA-1	GTTTCTAAGGCGTACA
TAAGCGTCATGCTAGT-1	TAAGCGTCATGCTAGT
TAAGTGCTCTATCCCG-1	TAAGTGCTCTATCCCG
TACACGAAGAATTGTG-1	TACACGAAGAATTGTG
TACACGACATACGCTA-1	TACACGACATACGCTA
TACAGTGCAAGTAATG-1	TACAGTGCAAGTAATG
TACCTATGTTTGGCGC-1	TACCTATGTTTGGCGC
TACCTATTCGATAGAA-1	TACCTATTCGATAGAA
TACCTTAAGTGTTGAA-1	TACCTTAAGTGTTGAA
TACCTTACACAAGTAA-1	TACCTTACACAAGTAA
TACCTTACATCTCGCT-1	TACCTTACATCTCGCT
TACCTTACATTAACCG-1	TACCTTACATTAACCG
TACGGATGTACCAGTT-1	TACGGATGTACCAGTT
TACGGGCCATAGTAAG-1	TACGGGCCATAGTAAG
TACGGTACAAACGTGG-1	TACGGTACAAACGTGG
TACTCATCAATGGAGC-1	TACTCATCAATGGAGC
TACTCATTCCGTACAA-1	TACTCATTCCGTACAA
TACTTACTCTAGAGTC-1	TACTTACTCTAGAGTC
TACTTGTGTTGGAGGT-1	TACTTGTGTTGGAGGT
TAGACCAAGGCATGTG-1	TAGACCAAGGCATGTG
TAGAGCTCAATAGCAA-1	TAGAGCTCAATAGCAA
TAGAGCTCAGCATACT-1	TAGAGCTCAGCATACT
TAGAGCTCATCGTCGG-1	TAGAGCTCATCGTCGG
TAGCCGGCAGTCTTCC-1	TAGCCGGCAGTCTTCC
TAGCCGGGTCCCGACA-1	TAGCCGGGTCCCGACA
TAGCCGGTCACTTCAT-1	TAGCCGGTCACTTCAT
TAGGCATAGACCGGAT-1	TAGGCATAGACCGGAT
TAGGCATTCAGTTGAC-1	TAGGCATTCAGTTGAC
TAGTGGTAGAGTAAGG-1	TAGTGGTAGAGTAAGG
TAGTTGGCACCGGAAA-1	TAGTTGGCACCGGAAA
TAGTTGGTCGGTTAAC-1	TAGTTGGTCGGTTAAC
TATCTCAAGAGGTACC-1	TATCTCAAGAGGTACC
TATCTCAGTGACGCCT-1	TATCTCAGTGACGCCT
TATCTCATCACATACG-1	TATCTCATCACATACG
TATCTCATCTCTAAGG-1	TATCTCATCTCTAAGG
TATGCCCAGTAGGTGC-1	TATGCCCAGTAGGTGC
TATGCCCGTCCGAATT-1	TATGCCCGTCCGAATT
TATGCCCGTCGTCTTC-1	TATGCCCGTCGTCTTC
TATGCCCGTGCAGGTA-1	TATGCCCGTGCAGGTA
TATTACCTCGTAGGTT-1	TATTACCTCGTAGGTT
TCAATCTGTCAGAAGC-1	TCAATCTGTCAGAAGC
TCAATCTGTCTACCTC-1	TCAATCTGTCTACCTC
TCACAAGAGTAGGTGC-1	TCACAAGAGTAGGTGC
TCAGATGCACAACGCC-1	TCAGATGCACAACGCC
TCAGATGCACATCCGG-1	TCAGATGCACATCCGG
TCAGATGCAGCGAACA-1	TCAGATGCAGCGAACA
TCAGCTCCACGACTCG-1	TCAGCTCCACGACTCG
TCAGCTCTCAAACCGT-1	TCAGCTCTCAAACCGT
TCAGCTCTCAATCTCT-1	TCAGCTCTCAATCTCT
TCAGCTCTCTCCTATA-1	TCAGCTCTCTCCTATA
TCAGCTCTCTTACCGC-1	TCAGCTCTCTTACCGC
TCAGGATAGGGAGTAA-1	TCAGGATAGGGAGTAA
TCATTACCAGTGACAG-1	TCATTACCAGTGACAG
TCATTTGGTCAGAGGT-1	TCATTTGGTCAGAGGT
TCCACACCAGTGACAG-1	TCCACACCAGTGACAG
TCCACACGTGTAATGA-1	TCCACACGTGTAATGA
TCCCGATAGATGTTAG-1	TCCCGATAGATGTTAG
TCCCGATCAGCCACCA-1	TCCCGATCAGCCACCA
TCGAGGCCACGGTTTA-1	TCGAGGCCACGGTTTA
TCGAGGCCATCCCATC-1	TCGAGGCCATCCCATC
TCGCGTTAGATCGATA-1	TCGCGTTAGATCGATA
TCGGGACGTCAACTGT-1	TCGGGACGTCAACTGT
TCGGGACGTGTAATGA-1	TCGGGACGTGTAATGA
TCGTAGAAGAAGATTC-1	TCGTAGAAGAAGATTC
TCGTAGATCACTTACT-1	TCGTAGATCACTTACT
TCGTAGATCATTTGGG-1	TCGTAGATCATTTGGG
TCTATTGGTGTGGCTC-1	TCTATTGGTGTGGCTC
TCTCATAAGTCTCAAC-1	TCTCATAAGTCTCAAC
TCTCATAGTTGCCTCT-1	TCTCATAGTTGCCTCT
TCTCTAACAGTTTACG-1	TCTCTAACAGTTTACG
TCTCTAAGTGGTCCGT-1	TCTCTAAGTGGTCCGT
TCTCTAAGTTAGGGTG-1	TCTCTAAGTTAGGGTG
TCTGAGAGTTCTCATT-1	TCTGAGAGTTCTCATT
TCTGAGATCATTGCGA-1	TCTGAGATCATTGCGA
TCTGGAACACGAGAGT-1	TCTGGAACACGAGAGT
TCTTTCCAGACTTTCG-1	TCTTTCCAGACTTTCG
TCTTTCCTCAGTCAGT-1	TCTTTCCTCAGTCAGT
TGAAAGACAAGCTGGA-1	TGAAAGACAAGCTGGA
TGACTAGAGGATTCGG-1	TGACTAGAGGATTCGG
TGACTAGGTTAGATGA-1	TGACTAGGTTAGATGA
TGACTTTTCACGACTA-1	TGACTTTTCACGACTA
TGACTTTTCTTGTACT-1	TGACTTTTCTTGTACT
TGAGCATAGGCTCATT-1	TGAGCATAGGCTCATT
TGAGCCGAGACACTAA-1	TGAGCCGAGACACTAA
TGAGCCGGTCTCTCGT-1	TGAGCCGGTCTCTCGT
TGATTTCCACCAGGCT-1	TGATTTCCACCAGGCT
TGATTTCTCTCAACTT-1	TGATTTCTCTCAACTT
TGCACCTGTTCAGACT-1	TGCACCTGTTCAGACT
TGCCAAAAGACCTTTG-1	TGCCAAAAGACCTTTG
TGCCAAACATCCCACT-1	TGCCAAACATCCCACT
TGCCAAACATTTGCTT-1	TGCCAAACATTTGCTT
TGCCAAAGTTGATTCG-1	TGCCAAAGTTGATTCG
TGCCAAATCCCAGGTG-1	TGCCAAATCCCAGGTG
TGCCCATCAGGGATTG-1	TGCCCATCAGGGATTG
TGCCCATTCCGGCACA-1	TGCCCATTCCGGCACA
TGCGCAGCATGCCTAA-1	TGCGCAGCATGCCTAA
TGCGGGTCATCCCATC-1	TGCGGGTCATCCCATC
TGCGTGGCAAAGAATC-1	TGCGTGGCAAAGAATC
TGCGTGGGTTCGCTAA-1	TGCGTGGGTTCGCTAA
TGCTACCCACGAGGTA-1	TGCTACCCACGAGGTA
TGCTGCTAGGCGATAC-1	TGCTGCTAGGCGATAC
TGGACGCGTCCCGACA-1	TGGACGCGTCCCGACA
TGGCCAGAGTACATGA-1	TGGCCAGAGTACATGA
TGGCCAGGTGGGTCAA-1	TGGCCAGGTGGGTCAA
TGGCCAGTCATGCATG-1	TGGCCAGTCATGCATG
TGGCGCAAGGGCTTCC-1	TGGCGCAAGGGCTTCC
TGGCGCAGTCTTCGTC-1	TGGCGCAGTCTTCGTC
TGGCTGGCACGTCTCT-1	TGGCTGGCACGTCTCT
TGGTTAGTCGGCGCTA-1	TGGTTAGTCGGCGCTA
TGGTTAGTCTATCCCG-1	TGGTTAGTCTATCCCG
TGTCCCACAAAGCGGT-1	TGTCCCACAAAGCGGT
TGTCCCACATACTACG-1	TGTCCCACATACTACG
TGTCCCATCCGTCAAA-1	TGTCCCATCCGTCAAA
TGTGGTAAGACCACGA-1	TGTGGTAAGACCACGA
TGTGTTTAGACTAGAT-1	TGTGTTTAGACTAGAT
TGTGTTTGTCATTAGC-1	TGTGTTTGTCATTAGC
TTAACTCAGTTTCCTT-1	TTAACTCAGTTTCCTT
TTAGGACAGGCCCTTG-1	TTAGGACAGGCCCTTG
TTAGGCAAGCTCTCGG-1	TTAGGCAAGCTCTCGG
TTAGGCAGTCTAGTCA-1	TTAGGCAGTCTAGTCA
TTAGGCATCAGATAAG-1	TTAGGCATCAGATAAG
TTAGTTCCACACATGT-1	TTAGTTCCACACATGT
TTAGTTCGTCTAGGTT-1	TTAGTTCGTCTAGGTT
TTATGCTTCCAGAAGG-1	TTATGCTTCCAGAAGG
TTATGCTTCGGAGCAA-1	TTATGCTTCGGAGCAA
TTCGAAGAGCTGTTCA-1	TTCGAAGAGCTGTTCA
TTCGAAGCACTTCGAA-1	TTCGAAGCACTTCGAA
TTCGGTCGTCTAACGT-1	TTCGGTCGTCTAACGT
TTCTTAGGTCACTTCC-1	TTCTTAGGTCACTTCC
TTGAACGTCAGAGGTG-1	TTGAACGTCAGAGGTG
TTGCCGTAGGCGTACA-1	TTGCCGTAGGCGTACA
TTGCCGTAGTGACATA-1	TTGCCGTAGTGACATA
TTGCCGTTCAAGGTAA-1	TTGCCGTTCAAGGTAA
TTGCCGTTCTACGAGT-1	TTGCCGTTCTACGAGT
TTGCGTCAGCGATCCC-1	TTGCGTCAGCGATCCC
TTGCGTCCATGTCCTC-1	TTGCGTCCATGTCCTC
TTGCGTCTCTTCAACT-1	TTGCGTCTCTTCAACT
TTGTAGGGTAAGGGAA-1	TTGTAGGGTAAGGGAA
TTTATGCAGTGAAGTT-1	TTTATGCAGTGAAGTT
TTTATGCTCAAAGACA-1	TTTATGCTCAAAGACA
TTTCCTCCATGAGCGA-1	TTTCCTCCATGAGCGA
TTTCCTCGTAAACCTC-1	TTTCCTCGTAAACCTC
TTTGCGCAGACGCAAC-1	TTTGCGCAGACGCAAC
TTTGCGCAGGCTCATT-1	TTTGCGCAGGCTCATT
TTTGGTTCACATGACT-1	TTTGGTTCACATGACT
TTTGGTTCACTACAGT-1	TTTGGTTCACTACAGT
TTTGGTTGTTGATTCG-1	TTTGGTTGTTGATTCG
TTTGTCAAGTTTAGGA-1	TTTGTCAAGTTTAGGA
TTTGTCACACTTAAGC-1	TTTGTCACACTTAAGC
